CCGTGTATAGG -> CGTGTATAGGG
TGGAATGGCAG -> GGAATGGCAGT
CGCACGGGAGA -> GCACGGGAGAA
TTTAGTATGAA -> TTAGTATGAAT
ATGTAACTGAC -> TGTAACTGACT
GATAGATCACC -> ATAGATCACCT
TACGAGGTCAA -> ACGAGGTCAAT
CTCCAAGCCCT -> TCCAAGCCCTA
GGTATTTCAGG -> GTATTTCAGGC
CGGCTTGGTAT -> GGCTTGGTATC
TCAAATTGCAG -> CAAATTGCAGC
TATTTTGTGTT -> ATTTTGTGTTC
GCGGATGCTAT -> CGGATGCTATT
TCGCGGGGAAT -> CGCGGGGAATA
TTGTGTGCTGA -> TGTGTGCTGAG
ATAAAAGTAAC -> TAAAAGTAACA
CTTCTGCCAAC -> TTCTGCCAACC
TTCTGCCAACC -> TCTGCCAACCC
CAAATACGCCG -> AAATACGCCGA
CTATAAGTTGA -> TATAAGTTGAG
GCCCTACGAGG -> CCCTACGAGGT
CCCTTCGAAAA -> CCTTCGAAAAC
CACATGGGGAT -> ACATGGGGATC
CATTCGAGCGA -> ATTCGAGCGAT
CATTAATAACC -> ATTAATAACCG
CCAAATTTGAG -> CAAATTTGAGT
AGGCCTTGTGC -> GGCCTTGTGCC
TTGGAATCCGA -> TGGAATCCGAA
GGGCAAACCAA -> GGCAAACCAAT
TGGGCAAGTCA -> GGGCAAGTCAG
CCATTGGTTGC -> CATTGGTTGCT
GGGGGCGGATG -> GGGGCGGATGC
GCTCGGATGGA -> CTCGGATGGAT
TACGGCAATGC -> ACGGCAATGCG
ACGACTATCCC -> CGACTATCCCA
GGATCGGAAAG -> GATCGGAAAGC
TTTCAACTGGG -> TTCAACTGGGC
ATTGTATTTCA -> TTGTATTTCAA
AAAATTAGGAG -> AAATTAGGAGT
TTCAGCGCCCC -> TCAGCGCCCCG
CATTTGGACAC -> ATTTGGACACA
GCGCGGAAATT -> CGCGGAAATTT
AATACGCCGAC -> ATACGCCGACT
ATTTTGTGTTC -> TTTTGTGTTCT
TTGGGTTTCAA -> TGGGTTTCAAC
AAGTACCGCTA -> AGTACCGCTAC
GTTCTGGACGA -> TTCTGGACGAG
CTCGGTCTTGG -> TCGGTCTTGGA
AGAAAGCACGA -> GAAAGCACGAC
ACATGGGGATC -> CATGGGGATCC
TTGCCGGTATT -> TGCCGGTATTT
AAGTCAGCTTT -> AGTCAGCTTTA
TAATTCGTTGT -> AATTCGTTGTT
CGTTCTAACCC -> GTTCTAACCCG
CTATGAAACGG -> TATGAAACGGG
CGACGGTAAGG -> GACGGTAAGGG
TTGGAATGGCA -> TGGAATGGCAG
CGAGCGGGACA -> GAGCGGGACAG
GTGTTGGAATC -> TGTTGGAATCC
CAACATTTTAC -> AACATTTTACG
TTGGACACACT -> TGGACACACTC
ATTATGTAACT -> TTATGTAACTG
TGCAATACGTC -> GCAATACGTCC
GTATCATGGGC -> TATCATGGGCA
GTGTGGACAAA -> TGTGGACAAAG
GTAACCCCCGC -> TAACCCCCGCT
GTATGGCGCTC -> TATGGCGCTCG
TTGGAATGTCG -> TGGAATGTCGC
GCTGAGGACAT -> CTGAGGACATT
CTCACCCGTAA -> TCACCCGTAAT
AAATTATAATC -> AATTATAATCG
GTTCTAACCCG -> TTCTAACCCGG
CCGGGCAAACC -> CGGGCAAACCA
TTTAGTGGATA -> TTAGTGGATAT
CTGCTCCAAGC -> TGCTCCAAGCC
TCCATGACCCA -> CCATGACCCAC
GTATTTCAGGC -> TATTTCAGGCT
TTCAACGGAGG -> TCAACGGAGGG
CAACAGGGTAG -> AACAGGGTAGA
ACTTCTGCCAA -> CTTCTGCCAAC
CGACTATCCCA -> GACTATCCCAG
TAAGGGTTGGG -> AAGGGTTGGGT
CCTATTTTAGT -> CTATTTTAGTA
AGGGTAGATGG -> GGGTAGATGGC
TGACTTGAACG -> GACTTGAACGG
GACGACTATCC -> ACGACTATCCC
GTCCCTAACTG -> TCCCTAACTGA
ACACCTCGTCT -> CACCTCGTCTC
TATGGGATCAC -> ATGGGATCACC
GGCAATTGCCA -> GCAATTGCCAG
ATCGGAAAGCA -> TCGGAAAGCAG
CGTTTTAGTGG -> GTTTTAGTGGA
GAGTGTATCTG -> AGTGTATCTGT
CACTGCCAGCG -> ACTGCCAGCGT
GGATTTGGTAT -> GATTTGGTATT
GAATCCGAAAG -> AATCCGAAAGT
CGTCCTAATAG -> GTCCTAATAGT
ATAGGATAGTA -> TAGGATAGTAC
GTATGCTGCTA -> TATGCTGCTAG
TTGTTTTCGCC -> TGTTTTCGCCT
CAGCGAGCGCG -> AGCGAGCGCGT
AATAGTAGAAG -> ATAGTAGAAGC
CTAGGCCTTGT -> TAGGCCTTGTG
TGGGCAAGTAA -> GGGCAAGTAAG
GGTTTGCTCCG -> GTTTGCTCCGA
TAGGAAAAAAC -> AGGAAAAAACT
ACCGGATGGGA -> CCGGATGGGAG
TAGTGGATATG -> AGTGGATATGC
GCTCACTATAG -> CTCACTATAGA
GGGGGCTGCTC -> GGGGCTGCTCT
TATCATGGGCA -> ATCATGGGCAT
ACCCGGTACGG -> CCCGGTACGGC
TGACGCTTGTG -> GACGCTTGTGG
AATGGCAGTTG -> ATGGCAGTTGC
GGATAGATATA -> GATAGATATAC
CTGCAAATTAT -> TGCAAATTATA
TCTAATATGGT -> CTAATATGGTA
CCCTACGAGGT -> CCTACGAGGTC
CCGCTACAAGA -> CGCTACAAGAA
CCAGTAAGGGA -> CAGTAAGGGAT
GCTGCTAGTCG -> CTGCTAGTCGA
ATCCCAGTCAT -> TCCCAGTCATT
ACCTTGGAATG -> CCTTGGAATGG
AAGTCAAATTG -> AGTCAAATTGC
CATTCCACAGT -> ATTCCACAGTA
TACGCACCCTC -> ACGCACCCTCT
GACTGTCTCGG -> ACTGTCTCGGT
AGGTTCGCAGG -> GGTTCGCAGGA
CCGCATCCAAA -> CGCATCCAAAA
GGGTGACGATC -> GGTGACGATCC
GGGGAATATTT -> GGGAATATTTT
GTGTGAAGACA -> TGTGAAGACAT
AGTGGATATGC -> GTGGATATGCA
CGAGGTCAATT -> GAGGTCAATTG
ATAGTACGTGG -> TAGTACGTGGT
GGATGGATGAT -> GATGGATGATG
TAGTTGCCGGT -> AGTTGCCGGTA
ATCCTACACCT -> TCCTACACCTA
TTACTTCTGCC -> TACTTCTGCCA
AGATAAAAGTA -> GATAAAAGTAA
ACTCGGGTGGC -> CTCGGGTGGCG
CAGACGCTATC -> AGACGCTATCA
AGGGATAGATA -> GGGATAGATAT
TGTCGCGTCAG -> GTCGCGTCAGA
TCATTTGAATG -> CATTTGAATGA
TTACCCTTCAT -> TACCCTTCATT
CGACTTAGAGG -> GACTTAGAGGG
ATTGCCAGTAA -> TTGCCAGTAAG
GTCAAATTGCA -> TCAAATTGCAG
TTGGGCAAGTC -> TGGGCAAGTCA
TCATTCCACAG -> CATTCCACAGT
TGTAGGTTCGC -> GTAGGTTCGCA
AGTGGGTCACA -> GTGGGTCACAG
TGAGATCGAAC -> GAGATCGAACT
ACGACGGTAAG -> CGACGGTAAGG
GGTAACAGATC -> GTAACAGATCC
GGGCAAGTCAG -> GGCAAGTCAGC
GCCAACATTTT -> CCAACATTTTA
GGAATGGCAGT -> GAATGGCAGTT
AACTGAGAATC -> ACTGAGAATCG
GACTTGAACGG -> ACTTGAACGGG
CAGGCAATTGC -> AGGCAATTGCC
ATTAATAACCG -> TTAATAACCGG
CCGACTGTCTC -> CGACTGTCTCG
TGCTCCGTGTA -> GCTCCGTGTAT
CGTGCAATACG -> GTGCAATACGT
GCAATACGTCC -> CAATACGTCCC
CAACAAAACTG -> AACAAAACTGG
TAACAGTGAGG -> AACAGTGAGGT
ATGACTTCGAC -> TGACTTCGACA
TTCACTCCTCT -> TCACTCCTCTA
TCGTTGTTTTC -> CGTTGTTTTCG
GAAAGCAGTTG -> AAAGCAGTTGT
GCTAGGCCTTG -> CTAGGCCTTGT
TGTAACTGACT -> GTAACTGACTC
GTCGTAAGTGT -> TCGTAAGTGTG
CTCACATGGGG -> TCACATGGGGA
TGCCTATGGGG -> GCCTATGGGGT
ATATAGTTGCC -> TATAGTTGCCG
AGGTGTTGGAA -> GGTGTTGGAAT
CATCGCGGGGA -> ATCGCGGGGAA
AAACTAATCAT -> AACTAATCATC
AATTTTAATTG -> ATTTTAATTGG
CCACCGGATGG -> CACCGGATGGG
ATAGTCGCCGC -> TAGTCGCCGCT
CCCAGTCATTT -> CCAGTCATTTA
TCAATTGTCAG -> CAATTGTCAGG
TCTCGCTTACC -> CTCGCTTACCT
TAGTCGCCGCT -> AGTCGCCGCTG
CTTGTTGACGC -> TTGTTGACGCT
CTAGCCTCATT -> TAGCCTCATTT
GTAGGTCCACT -> TAGGTCCACTG
GCATTTCAGCG -> CATTTCAGCGC
CTCGCTTACCT -> TCGCTTACCTG
CTAATAGTCGC -> TAATAGTCGCC
CAATTATTCGA -> AATTATTCGAC
GCATCCAAAAG -> CATCCAAAAGG
TCCTACACCTA -> CCTACACCTAT
GGACGAGCGGG -> GACGAGCGGGA
AACGTCCTAAT -> ACGTCCTAATA
CGATTTAGAGA -> GATTTAGAGAC
AGGCTATCCTT -> GGCTATCCTTC
GGGAGAATCCA -> GGAGAATCCAT
GATCCCTGGCA -> ATCCCTGGCAT
GGGCATTTCAG -> GGCATTTCAGC
GAATCCTGCAA -> AATCCTGCAAA
CCGCTGAGGAC -> CGCTGAGGACA
TTTTAGTATGA -> TTTAGTATGAA
AAGAGGCTATC -> AGAGGCTATCC
GTGCTGAGCAA -> TGCTGAGCAAT
GGATGGGAGTC -> GATGGGAGTCC
TGTGCCAACAT -> GTGCCAACATT
TCAGCTTTAAT -> CAGCTTTAATT
AGGTAACCCCC -> GGTAACCCCCG
CGGAAAGCAGT -> GGAAAGCAGTT
GCAATGCGGGT -> CAATGCGGGTG
CGAGTGGGTCA -> GAGTGGGTCAC
GCGCTCGTTTT -> CGCTCGTTTTA
GCGAGGAACTG -> CGAGGAACTGC
ACCCACCGGAT -> CCCACCGGATG
CTAATCATCTG -> TAATCATCTGT
CATTGCTCGGA -> ATTGCTCGGAT
GAGCAATGGGC -> AGCAATGGGCC
TCATCTGTCCT -> CATCTGTCCTC
CCGACTTAGAG -> CGACTTAGAGG
CAATGACTTCG -> AATGACTTCGA
CTATTTCGCAG -> TATTTCGCAGC
TTCGCAGCCAA -> TCGCAGCCAAT
CACTCGGGTGG -> ACTCGGGTGGC
CCACAGTACCA -> CACAGTACCAG
AACTGATCCTG -> ACTGATCCTGA
GCATAAAACTC -> CATAAAACTCG
GACCAACCCTA -> ACCAACCCTAC
GCGAGTGGGTC -> CGAGTGGGTCA
GAATTCTACGC -> AATTCTACGCA
AACCGGAAGAG -> ACCGGAAGAGG
AGGCAATTGCC -> GGCAATTGCCA
CCCGGGAACGG -> CCGGGAACGGC
AGTAACAGTGA -> GTAACAGTGAG
TTATGTAACTG -> TATGTAACTGA
CTACAAGAAAA -> TACAAGAAAAC
CTATCATTCCA -> TATCATTCCAC
GCCATCGCGGG -> CCATCGCGGGG
GGGATCACCAT -> GGATCACCATT
GAAAACATGTT -> AAAACATGTTC
CTGACTTGAAC -> TGACTTGAACG
GCCCCAATTAT -> CCCCAATTATT
GAGGGGGCTGC -> AGGGGGCTGCT
ATGGGGATCCG -> TGGGGATCCGA
GATCCTGATCC -> ATCCTGATCCC
GTCGAATTTTA -> TCGAATTTTAC
GGTGGACCGAA -> GTGGACCGAAT
TGAGGACATTA -> GAGGACATTAA
CATTGGTTGCT -> ATTGGTTGCTC
TGACTCACTAG -> GACTCACTAGC
TTAATAACCGG -> TAATAACCGGA
CTCTAATATGG -> TCTAATATGGT
GAACGCCACCC -> AACGCCACCCA
TTCTAACCCGG -> TCTAACCCGGT
CACGACGTTCT -> ACGACGTTCTA
CCTCTAATATG -> CTCTAATATGG
AACGCCGGACT -> ACGCCGGACTA
GGGCAAGTAAG -> GGCAAGTAAGG
CTCACTAGCCT -> TCACTAGCCTC
AACGGAGGGTT -> ACGGAGGGTTT
CGCTTACCTGC -> GCTTACCTGCT
GTTGGAATCCG -> TTGGAATCCGA
ATTATATCGGG -> TTATATCGGGA
CGTAAGTGTGG -> GTAAGTGTGGA
TTTCCTGTAGC -> TTCCTGTAGCG
CTGCCAGCGTA -> TGCCAGCGTAT
GGCAAGTAAGG -> GCAAGTAAGGG
CTGCTCCCAAA -> TGCTCCCAAAC
GTATGAAGGCC -> TATGAAGGCCC
TGTGTTCTAAA -> GTGTTCTAAAG
CGCATCCAAAA -> GCATCCAAAAG
CATGGGGATCC -> ATGGGGATCCG
AATCGGCTTGG -> ATCGGCTTGGT
TGGGTTAAGTC -> GGGTTAAGTCA
AGATCGAACTG -> GATCGAACTGA
TCACATGGGGA -> CACATGGGGAT
CCTCTTATGGT -> CTCTTATGGTG
ATACAGGTGGG -> TACAGGTGGGC
ACGTCCCTAAC -> CGTCCCTAACT
CGAACTGAGAA -> GAACTGAGAAT
CCTTCACTCCT -> CTTCACTCCTC
CCTTCGAAAAC -> CTTCGAAAACG
CACCCGTAATC -> ACCCGTAATCT
TTTTACGCGCA -> TTTACGCGCAC
GCAGGATCTCA -> CAGGATCTCAC
GCGTCGTGCAC -> CGTCGTGCACG
GATTTAGAGAC -> ATTTAGAGACC
GTCAGACGCTA -> TCAGACGCTAT
AAAACTATCCA -> AAACTATCCAT
TGCTGCTAGTC -> GCTGCTAGTCG
CACGGGAGAAT -> ACGGGAGAATC
ATCCCTAGGGT -> TCCCTAGGGTA
TGTCAGGCTCC -> GTCAGGCTCCC
TGCCAACATTT -> GCCAACATTTT
TTACGCGCACG -> TACGCGCACGG
CTTCCAACAAA -> TTCCAACAAAA
CACCCCCTGAA -> ACCCCCTGAAG
ACTGGGCAAGT -> CTGGGCAAGTA
ACAGGTGGGCG -> CAGGTGGGCGA
AAGACATTCTT -> AGACATTCTTG
TCCGAGCTCGG -> CCGAGCTCGGA
GAATGACGCAG -> AATGACGCAGC
AGCCTCATTTG -> GCCTCATTTGA
ATCCTGATCCC -> TCCTGATCCCT
GGTGACGATCC -> GTGACGATCCT
TGGGATTGGGC -> GGGATTGGGCA
AAGAACCTCAC -> AGAACCTCACA
CTTGGTATCAT -> TTGGTATCATG
ACTGACTCGTA -> CTGACTCGTAT
TCTTATGGTGC -> CTTATGGTGCT
AGGATAGTACG -> GGATAGTACGT
AGGGGTAAGTG -> GGGGTAAGTGC
TGGATACCCGG -> GGATACCCGGG
AAGAATAAGGG -> AGAATAAGGGT
GTGTCGTAAGT -> TGTCGTAAGTG
TGGCATCATAG -> GGCATCATAGG
AGAATCGTGTG -> GAATCGTGTGC
GCCTAACCGTC -> CCTAACCGTCT
CAGCTTACCGC -> AGCTTACCGCA
TCCTCGTGCCC -> CCTCGTGCCCA
GCGATCTTCAA -> CGATCTTCAAC
TGGGGATCCGA -> GGGGATCCGAT
AGGGCTCACTA -> GGGCTCACTAT
GCCTATGAAAC -> CCTATGAAACG
ATTGTCAGGCT -> TTGTCAGGCTC
GATCCCTTCCT -> ATCCCTTCCTC
GTATCAACAGG -> TATCAACAGGG
CGGTACGGCAA -> GGTACGGCAAT
TTATTCGACAC -> TATTCGACACA
CGACACATACA -> GACACATACAG
TTGTTGACGCT -> TGTTGACGCTT
GGAATCCGAAA -> GAATCCGAAAG
CTCGCATAAAA -> TCGCATAAAAC
TGACGCAGCTT -> GACGCAGCTTA
CAGATCCCTGG -> AGATCCCTGGC
TTAAAGAACCT -> TAAAGAACCTC
AGGAGTGTATC -> GGAGTGTATCT
TCGAAAACGTC -> CGAAAACGTCC
CTTTTCCTGTA -> TTTTCCTGTAG
GGACATTTACT -> GACATTTACTA
TCGTGCACGTA -> CGTGCACGTAG
GTCGCGTCAGA -> TCGCGTCAGAT
CTCGGACTTTT -> TCGGACTTTTC
CTGAGAATCGT -> TGAGAATCGTG
ACGGCAGACCA -> CGGCAGACCAA
CGTCTCGCTTA -> GTCTCGCTTAC
TGAGGTGTTGG -> GAGGTGTTGGA
AACCTCACATG -> ACCTCACATGG
TGACCCACCGG -> GACCCACCGGA
TTAATTACTAT -> TAATTACTATA
GTGGATATGCA -> TGGATATGCAG
CTTTAATTACT -> TTTAATTACTA
ATTGCCATCGC -> TTGCCATCGCG
CGAAAGTCAGA -> GAAAGTCAGAC
CTTAAAAGTAT -> TTAAAAGTATC
GGACTACGACG -> GACTACGACGG
GAATATTTTGT -> AATATTTTGTG
ACCGAATTCTA -> CCGAATTCTAC
GAAACGGGGCT -> AAACGGGGCTG
CCGCAGTGCTC -> CGCAGTGCTCC
TGAACGGGGGG -> GAACGGGGGGC
CTCGATTTAGA -> TCGATTTAGAG
ACAGAATCCTG -> CAGAATCCTGC
GGGAATATTTT -> GGAATATTTTG
TCCGCACTCGC -> CCGCACTCGCA
GCAGCCTATGA -> CAGCCTATGAA
TATATCGGGAT -> ATATCGGGATC
TTGGTTGCTCA -> TGGTTGCTCAA
TTGTATGGCGC -> TGTATGGCGCT
CGGCGGGTTAA -> GGCGGGTTAAA
ACAGATCCCTG -> CAGATCCCTGG
ACTTTTCCTGT -> CTTTTCCTGTA
ACGTGGTGATT -> CGTGGTGATTG
ACGCGCACGGG -> CGCGCACGGGA
CAGCTTTAATT -> AGCTTTAATTA
AGATCACCTTG -> GATCACCTTGG
ACGCGAACGCC -> CGCGAACGCCG
CTGCTCTCGGG -> TGCTCTCGGGT
TTGCCATCGCG -> TGCCATCGCGG
ACGAGGTCAAT -> CGAGGTCAATT
GGCTTGGTATC -> GCTTGGTATCA
GATCGGAAAGC -> ATCGGAAAGCA
GCCGACTTAGA -> CCGACTTAGAG
ATAGTTGCCGG -> TAGTTGCCGGT
TCGTTTTAGTG -> CGTTTTAGTGG
TAGCGAGTGGG -> AGCGAGTGGGT
TTACCTGCTCC -> TACCTGCTCCA
TAGAGACCTCT -> AGAGACCTCTG
TAGGTGGCACG -> AGGTGGCACGT
GTGAGATCGAA -> TGAGATCGAAC
GTTGTATGGCG -> TTGTATGGCGC
ACAGGCAATTG -> CAGGCAATTGC
GCGCCTAACCG -> CGCCTAACCGT
TTCCTCGTGCC -> TCCTCGTGCCC
ATGGCCGTTTC -> TGGCCGTTTCA
TCGTATTATAT -> CGTATTATATC
GTAACTGACTC -> TAACTGACTCA
CCATTCCGAGC -> CATTCCGAGCT
CTAACCCGGTA -> TAACCCGGTAC
TCGAATTTTAC -> CGAATTTTACT
GTCAGATAATT -> TCAGATAATTC
CGAGCGCGTCG -> GAGCGCGTCGT
AGTACGTGGTG -> GTACGTGGTGA
GTTCGCAGGAT -> TTCGCAGGATC
TCCCGGGAACG -> CCCGGGAACGG
CCATCGCGGGG -> CATCGCGGGGA
GGGGCTTGGAT -> GGGCTTGGATA
TAACTGACTCA -> AACTGACTCAC
CGTCCCTAACT -> GTCCCTAACTG
TGCAGCCTATG -> GCAGCCTATGA
AGCGTGCAATA -> GCGTGCAATAC
TCCCTAACTGA -> CCCTAACTGAT
CCCTGAAGAAT -> CCTGAAGAATA
TGGTAACACTA -> GGTAACACTAG
CAGTTGCTGTT -> AGTTGCTGTTC
CCGGTATTTCA -> CGGTATTTCAG
GCAGTTGTATG -> CAGTTGTATGG
ATGACCCACCG -> TGACCCACCGG
GGTACGGCAAT -> GTACGGCAATG
AGAATCCTGCA -> GAATCCTGCAA
TTTGGTATTAT -> TTGGTATTATG
TCCCTAGGGTA -> CCCTAGGGTAA
GAAAGCCATAT -> AAAGCCATATA
GCTCGTTTTAG -> CTCGTTTTAGT
ATCCTGCAAAT -> TCCTGCAAATT
TCACCATTTGG -> CACCATTTGGA
AGCGTATAGCC -> GCGTATAGCCT
AATAGGATAGT -> ATAGGATAGTA
CTCTCGGGTTC -> TCTCGGGTTCT
GCACGTAGTAG -> CACGTAGTAGG
GGCATCATAGG -> GCATCATAGGA
GTGCACGTAGT -> TGCACGTAGTA
TCATTTGGAAT -> CATTTGGAATG
GGTCCACTGCC -> GTCCACTGCCA
TGTATGCTGCT -> GTATGCTGCTA
CTAGGGTAACA -> TAGGGTAACAG
ACATGTTCTGG -> CATGTTCTGGA
TAGCCTTAAAA -> AGCCTTAAAAG
TATTTCAGGCT -> ATTTCAGGCTA
GGGTAGATGGC -> GGTAGATGGCC
ACGTATGAATA -> CGTATGAATAG
CTCTAGGTAAC -> TCTAGGTAACC
CCTTCATTTGG -> CTTCATTTGGA
ATTTTACGCGC -> TTTTACGCGCA
ATCTTCAACCT -> TCTTCAACCTC
AGCTTTAATTA -> GCTTTAATTAC
AGACGCTATCA -> GACGCTATCAT
GGATAGATCAC -> GATAGATCACC
TGGATATGCAG -> GGATATGCAGG
GCCTATGGGGT -> CCTATGGGGTG
GCGAACGCCGG -> CGAACGCCGGA
ATCGTTTGTGT -> TCGTTTGTGTG
CTGTCCTCTAG -> TGTCCTCTAGG
CGAACGCCGGA -> GAACGCCGGAC
ATTCGACACAT -> TTCGACACATC
AATCCGAAAGT -> ATCCGAAAGTC
GCGGGGAATAT -> CGGGGAATATT
ATGTAGATAAA -> TGTAGATAAAA
GATTGTATTTC -> ATTGTATTTCA
GTGGACAAAGT -> TGGACAAAGTA
CTATTTTAGTA -> TATTTTAGTAT
TCATGGGCATT -> CATGGGCATTT
CTTGCTCGATT -> TTGCTCGATTT
GGGTGGACCGA -> GGTGGACCGAA
GCACGTTCTAA -> CACGTTCTAAC
AGCCTTAAAAG -> GCCTTAAAAGT
GGAAATTTTAA -> GAAATTTTAAT
GACTATCCCAG -> ACTATCCCAGT
TGTTGGAATCC -> GTTGGAATCCG
AGATGGTTATG -> GATGGTTATGG
GGCATTTCAGC -> GCATTTCAGCG
TCCCAAACTAA -> CCCAAACTAAT
CTACGCACCCT -> TACGCACCCTC
CCAACCCAAAT -> CAACCCAAATT
CGGGTTCTTGT -> GGGTTCTTGTT
CGGCAGACCAA -> GGCAGACCAAC
GGGGTGCCGTT -> GGGTGCCGTTG
TCACCTTGGAA -> CACCTTGGAAT
AACAGTGAGGT -> ACAGTGAGGTG
AGCAATGGGCC -> GCAATGGGCCC
GACAGGCAATT -> ACAGGCAATTG
ATTATTCGACA -> TTATTCGACAC
ATCCGATTGCC -> TCCGATTGCCA
GTAAGGGACTT -> TAAGGGACTTA
GTAGAAGCACA -> TAGAAGCACAC
GGATCCGATTG -> GATCCGATTGC
GTTGTTTTCGC -> TTGTTTTCGCC
TACGCGCACGG -> ACGCGCACGGG
CAACCCAAATT -> AACCCAAATTT
ACAGCGAGCGC -> CAGCGAGCGCG
AATCATCTGTC -> ATCATCTGTCC
AGTGTATCTGT -> GTGTATCTGTA
GATGGCCGTTT -> ATGGCCGTTTC
GTAAGTGTGGA -> TAAGTGTGGAC
GACATTCTTGA -> ACATTCTTGAA
CAACCCTACGT -> AACCCTACGTA
GGACATTAATA -> GACATTAATAA
GTGCCCATTGG -> TGCCCATTGGT
ATCCATTCGAG -> TCCATTCGAGC
CGCTGTAGGTT -> GCTGTAGGTTC
TGAATAGGATA -> GAATAGGATAG
TACTTCTGCCA -> ACTTCTGCCAA
AAGGCCCGCAG -> AGGCCCGCAGT
TATCGGGATCG -> ATCGGGATCGT
AATACGTCCCT -> ATACGTCCCTA
CCGCACTCGCA -> CGCACTCGCAT
AGTTGTATGGC -> GTTGTATGGCG
ATCAACAGGGT -> TCAACAGGGTA
AAAGCAGTTGT -> AAGCAGTTGTA
AACTAATCATC -> ACTAATCATCT
TCAGACGCTAT -> CAGACGCTATC
TTGAACGGGGG -> TGAACGGGGGG
TTCCGAGCTCG -> TCCGAGCTCGG
ACGCCACCCAT -> CGCCACCCATT
CCGAGCTCGGA -> CGAGCTCGGAC
CCTCTAGGTAA -> CTCTAGGTAAC
ACCTCACATGG -> CCTCACATGGG
TGGATGATGAA -> GGATGATGAAA
CAGTACCAGTG -> AGTACCAGTGT
ATGGCGCTCGT -> TGGCGCTCGTT
GTTCTAGGTGG -> TTCTAGGTGGC
GCCACCCATTC -> CCACCCATTCC
CAAACAGAATC -> AAACAGAATCC
GTTGAGAGGGT -> TTGAGAGGGTG
TCGGCGGGTTA -> CGGCGGGTTAA
TTGTGTTCTAA -> TGTGTTCTAAA
AGTCCCGGGAA -> GTCCCGGGAAC
GTTGAGCGTGC -> TTGAGCGTGCA
AACAGGGTAGA -> ACAGGGTAGAT
GATAGTACGTG -> ATAGTACGTGG
CATGACCCACC -> ATGACCCACCG
ATGAAGGCCCG -> TGAAGGCCCGC
CAAACAGTCTT -> AAACAGTCTTG
CTGTCTCGGTC -> TGTCTCGGTCT
AGCCAATCGTG -> GCCAATCGTGT
CGGATGCTATT -> GGATGCTATTT
TCCAAAAGGGC -> CCAAAAGGGCT
AGGTCAATTGT -> GGTCAATTGTC
GAGGTGTTGGA -> AGGTGTTGGAA
CAGTGTCGTAA -> AGTGTCGTAAG
CGACTGTCTCG -> GACTGTCTCGG
AGCTCGGACTT -> GCTCGGACTTT
TAATTGGGATT -> AATTGGGATTG
CCTATGGGGTG -> CTATGGGGTGC
GATCGTTTGTG -> ATCGTTTGTGT
AACAGAATCCT -> ACAGAATCCTG
GCATCATAGGA -> CATCATAGGAA
TAGGAGTGTAT -> AGGAGTGTATC
CAAATTTGAGT -> AAATTTGAGTG
TGGATCGGAAA -> GGATCGGAAAG
TCTTGAACGCC -> CTTGAACGCCA
TTTGTGTGCTG -> TTGTGTGCTGA
CTCCCTCTAAT -> TCCCTCTAATA
TAGTATGAATC -> AGTATGAATCG
TGGAATCCGAA -> GGAATCCGAAA
GAGCTCGGACT -> AGCTCGGACTT
CAGACCAACCC -> AGACCAACCCT
CGCAGTGCTCC -> GCAGTGCTCCG
ACGACTGACTA -> CGACTGACTAA
TGCCACTGACT -> GCCACTGACTT
GGAAAGCAGTT -> GAAAGCAGTTG
AGGCTAGGCCT -> GGCTAGGCCTT
CCTCACATGGG -> CTCACATGGGG
TATAGTTGCCG -> ATAGTTGCCGG
CTGATCCTGAT -> TGATCCTGATC
TCGACACATAC -> CGACACATACA
AGGGTTTGCTC -> GGGTTTGCTCC
CCACCCATTCC -> CACCCATTCCG
GTAGATAAAAG -> TAGATAAAAGT
TTACTATAAGT -> TACTATAAGTT
TTTCAGGCTAG -> TTCAGGCTAGG
CTGTAGCGAGT -> TGTAGCGAGTG
GACGCAGCTTA -> ACGCAGCTTAC
GACTTTTCCTG -> ACTTTTCCTGT
ATCCGAAAGTC -> TCCGAAAGTCA
GTTTCAACTGG -> TTTCAACTGGG
TTTCGCCTGAT -> TTCGCCTGATG
CGCGCACGGGA -> GCGCACGGGAG
GTCTCGGTCTT -> TCTCGGTCTTG
CTCCCTTCACT -> TCCCTTCACTC
CGTGTGAAGAC -> GTGTGAAGACA
GCTCCCAAACT -> CTCCCAAACTA
CTGATGTCGCA -> TGATGTCGCAC
ATGGGGTGCCG -> TGGGGTGCCGT
CGCGTCGTGCA -> GCGTCGTGCAC
CCTTCGCAGAA -> CTTCGCAGAAA
CCGAAAGTCAG -> CGAAAGTCAGA
TCGCGTCAGAT -> CGCGTCAGATA
TACGTCCCTAA -> ACGTCCCTAAC
CCTAGGGTAAC -> CTAGGGTAACA
ATTTGGACACA -> TTTGGACACAC
AGCGAGCGCGT -> GCGAGCGCGTC
TAAAATTAGGA -> AAAATTAGGAG
AACATGTTCTG -> ACATGTTCTGG
ACTTCGACACA -> CTTCGACACAT
ACGCTATCATT -> CGCTATCATTC
GCTAGTCGAAT -> CTAGTCGAATT
TAACACTAGAT -> AACACTAGATG
CGCCACCCATT -> GCCACCCATTC
CCTCGTCTCGG -> CTCGTCTCGGC
GATAATTCGTT -> ATAATTCGTTG
CTCGGATGGAT -> TCGGATGGATG
CATTTTACGCG -> ATTTTACGCGC
CCCTTCCTCGT -> CCTTCCTCGTG
GCAAATTATAA -> CAAATTATAAT
GGACAAAGTAC -> GACAAAGTACC
TCACAGCGAGC -> CACAGCGAGCG
CCCTGGCATCA -> CCTGGCATCAT
AACCCCCGCTG -> ACCCCCGCTGT
ACGCCGGACTA -> CGCCGGACTAC
TCGTCTCGGCG -> CGTCTCGGCGG
AAAAACTATCC -> AAAACTATCCA
ACAGTCTTGCT -> CAGTCTTGCTC
CTTACCTGCTC -> TTACCTGCTCC
GCGGGTTAAAA -> CGGGTTAAAAT
TCGTGCCCATT -> CGTGCCCATTG
CATACAGGTGG -> ATACAGGTGGG
CATCATAGGAA -> ATCATAGGAAA
AAGTGTGGACA -> AGTGTGGACAA
ACCCTACGTAT -> CCCTACGTATG
TATGCTGCTAG -> ATGCTGCTAGT
CTCACTATAGA -> TCACTATAGAA
GGAAAAAACTA -> GAAAAAACTAT
TGTGGGGGTGG -> GTGGGGGTGGA
TCTGTCCTCTA -> CTGTCCTCTAG
TGTGCTGAGCA -> GTGCTGAGCAA
ATTCGTTGTTT -> TTCGTTGTTTT
TTCGCAGGATC -> TCGCAGGATCT
ATTTGAATGAC -> TTTGAATGACG
GTGTGCTGAGC -> TGTGCTGAGCA
CCTATGAAACG -> CTATGAAACGG
AGAACCATGTA -> GAACCATGTAG
CTTGAACGGGG -> TTGAACGGGGG
GGGGGGCGGAT -> GGGGGCGGATG
AAGCAGTTGTA -> AGCAGTTGTAT
CCTGTAGCGAG -> CTGTAGCGAGT
ATTTACTATAC -> TTTACTATACG
TCCACTGCCAG -> CCACTGCCAGC
CAGAATCCTGC -> AGAATCCTGCA
GGATTGGGCAA -> GATTGGGCAAG
GAACCTCACAT -> AACCTCACATG
CAACTGGGCAA -> AACTGGGCAAG
CCCGGTACGGC -> CCGGTACGGCA
ATCATTCCACA -> TCATTCCACAG
GAGGGTGCGCG -> AGGGTGCGCGG
ATGCAGGGATA -> TGCAGGGATAG
AGGATCTCACC -> GGATCTCACCC
ATGAAAGCCAT -> TGAAAGCCATA
CATAGGAAAAA -> ATAGGAAAAAA
TCTAACCCGGT -> CTAACCCGGTA
ATAGATCACCT -> TAGATCACCTT
AATTTTACTTC -> ATTTTACTTCT
TATGAATCGGC -> ATGAATCGGCT
GAATGGCAGTT -> AATGGCAGTTG
TCCGTGTATAG -> CCGTGTATAGG
TGTAGCGAGTG -> GTAGCGAGTGG
GACCTCTGCTC -> ACCTCTGCTCC
TGATCCCTTCC -> GATCCCTTCCT
CCCCAATTATT -> CCCAATTATTC
TCTTGTTGACG -> CTTGTTGACGC
CCGATTGCCAT -> CGATTGCCATC
AGTTGCTGTTC -> GTTGCTGTTCC
CAGCCTATGAA -> AGCCTATGAAA
AAAAGTATCAA -> AAAGTATCAAC
TCGCAGAAAGC -> CGCAGAAAGCA
TTCGAGCGATC -> TCGAGCGATCT
GGCGCCTAACC -> GCGCCTAACCG
GAAGGCCCGCA -> AAGGCCCGCAG
GCTCAAACAGA -> CTCAAACAGAA
GGACCGAATTC -> GACCGAATTCT
ACAAAACTGGG -> CAAAACTGGGT
GTGTGCCAACA -> TGTGCCAACAT
CTCTGCTCCCA -> TCTGCTCCCAA
TCGGGGCTTGG -> CGGGGCTTGGA
ACCCGGGCAAA -> CCCGGGCAAAC
AGACCTCTGCT -> GACCTCTGCTC
GCACTCGCATA -> CACTCGCATAA
TGTATGGCGCT -> GTATGGCGCTC
CACCTTGGAAT -> ACCTTGGAATG
GCCTGATGTCG -> CCTGATGTCGC
AATTGGGATTG -> ATTGGGATTGG
TGGCACGTTCT -> GGCACGTTCTA
CAAGCCCTACG -> AAGCCCTACGA
CACCTCGTCTC -> ACCTCGTCTCG
TAAGTTGAGCG -> AAGTTGAGCGT
GCCCATTGGTT -> CCCATTGGTTG
TATTTCAACGG -> ATTTCAACGGA
CCCCCGCTGTA -> CCCCGCTGTAG
CCACTGCCAGC -> CACTGCCAGCG
TAAGGGATAGA -> AAGGGATAGAT
CGTGGTGATTG -> GTGGTGATTGT
AGGATTTGGTA -> GGATTTGGTAT
ACGCAGCTTAC -> CGCAGCTTACC
CGCGGGGAATA -> GCGGGGAATAT
AGGGACTTACC -> GGGACTTACCC
AGAATAAGGGT -> GAATAAGGGTT
TACCAGTGTCG -> ACCAGTGTCGT
TCAGCGCCCCG -> CAGCGCCCCGT
GGTTATGGGAT -> GTTATGGGATC
CAAGTAAGGGA -> AAGTAAGGGAC
GTGTTCTAAAG -> TGTTCTAAAGT
GATTGGGCAAG -> ATTGGGCAAGT
CCCGTAATCTT -> CCGTAATCTTC
CCCTAGGGTAA -> CCTAGGGTAAC
GTCAGGCTCCC -> TCAGGCTCCCT
GGTGCTCAAAC -> GTGCTCAAACA
AAGCACACCTC -> AGCACACCTCG
TGGTGATTGTA -> GGTGATTGTAT
GCTCGGACTTT -> CTCGGACTTTT
AGCCATATAGT -> GCCATATAGTT
GACCCACCGGA -> ACCCACCGGAT
TACGCGAACGC -> ACGCGAACGCC
ACGCTTGTGGG -> CGCTTGTGGGG
ATTCCGAGCTC -> TTCCGAGCTCG
GTTGCTCAAAC -> TTGCTCAAACA
TGAAGACATTC -> GAAGACATTCT
CGGTATTTCAG -> GGTATTTCAGG
CACTAGATGGT -> ACTAGATGGTT
CCATTTGGACA -> CATTTGGACAC
CGCAGGATCTC -> GCAGGATCTCA
GGGGATCCGAT -> GGGATCCGATT
AGATATACGAC -> GATATACGACT
GGGTAACAGAT -> GGTAACAGATC
TTCGTTGTTTT -> TCGTTGTTTTC
CAAATTATAAT -> AAATTATAATC
ACTGTCTCGGT -> CTGTCTCGGTC
GATGGATGATG -> ATGGATGATGA
GATGCTATTTC -> ATGCTATTTCG
ACTGCCACTGA -> CTGCCACTGAC
GCTCGATTTAG -> CTCGATTTAGA
CGGAAATTTTA -> GGAAATTTTAA
AATCTTCCAAC -> ATCTTCCAACA
GGTTGCTCAAA -> GTTGCTCAAAC
TGCTCTCGGGT -> GCTCTCGGGTT
AAGCACGACGT -> AGCACGACGTT
AATCGTGTGCC -> ATCGTGTGCCA
CGTAGTAGGTC -> GTAGTAGGTCC
AAGCCCTACGA -> AGCCCTACGAG
AACCTCCCTCT -> ACCTCCCTCTA
ACACATCCCTA -> CACATCCCTAG
TGAGTGAGATC -> GAGTGAGATCG
AGACCAACCCT -> GACCAACCCTA
CCGGAAGAGGC -> CGGAAGAGGCT
CGATCCTACAC -> GATCCTACACC
GAGCGCGTCGT -> AGCGCGTCGTG
GGACTTACCCT -> GACTTACCCTT
GGGATCCGATT -> GGATCCGATTG
CGTAATCTTCC -> GTAATCTTCCA
TGCTCCGACTG -> GCTCCGACTGT
GTAGCGAGTGG -> TAGCGAGTGGG
TCTGCTCCCAA -> CTGCTCCCAAA
ATTTGGAATGT -> TTTGGAATGTC
CAAGTCAGCTT -> AAGTCAGCTTT
GTAACACTAGA -> TAACACTAGAT
GATCCGATTGC -> ATCCGATTGCC
GCGCGTCGTGC -> CGCGTCGTGCA
GAGGAACTGCC -> AGGAACTGCCA
CAATCGTGTGA -> AATCGTGTGAA
GTCTTGCTCGA -> TCTTGCTCGAT
AAGTAACAGTG -> AGTAACAGTGA
CCGGACTACGA -> CGGACTACGAC
CTGGACGAGCG -> TGGACGAGCGG
TATGGCGCTCG -> ATGGCGCTCGT
TAAAACTCGGG -> AAAACTCGGGG
CGTATTATATC -> GTATTATATCG
GGCGAGGAACT -> GCGAGGAACTG
TACCGCTACAA -> ACCGCTACAAG
TCAGATAATTC -> CAGATAATTCG
GATGAAAGCCA -> ATGAAAGCCAT
AACAAAACTGG -> ACAAAACTGGG
TAGGTCCACTG -> AGGTCCACTGC
CCCATTCCGAG -> CCATTCCGAGC
CATTCCGAGCT -> ATTCCGAGCTC
ATTTCAGGCTA -> TTTCAGGCTAG
CTGTAGGTTCG -> TGTAGGTTCGC
CCATGACCCAC -> CATGACCCACC
GGCAGTTGCTG -> GCAGTTGCTGT
TTTTGTGTTCT -> TTTGTGTTCTA
GAATCCATGAC -> AATCCATGACC
AAGGGTTGGGT -> AGGGTTGGGTT
ATCCAAAAGGG -> TCCAAAAGGGC
GGCAAACCAAT -> GCAAACCAATG
CGCAGCTTACC -> GCAGCTTACCG
TTCATTTGGAA -> TCATTTGGAAT
CAGCGTATAGC -> AGCGTATAGCC
TTGGTATCATG -> TGGTATCATGG
TCCTGATCCCT -> CCTGATCCCTT
TCTTCCAACAA -> CTTCCAACAAA
AAATACGCCGA -> AATACGCCGAC
GCTATCATTCC -> CTATCATTCCA
GTAACAGATCC -> TAACAGATCCC
CTAAAGTATGA -> TAAAGTATGAA
GAGAATCCATG -> AGAATCCATGA
GCCGTTGAGAG -> CCGTTGAGAGG
GAGCGATCTTC -> AGCGATCTTCA
CTGACTCGTAT -> TGACTCGTATT
AACTGACTCAC -> ACTGACTCACT
GTTGCCGGTAT -> TTGCCGGTATT
CAGTAAGGGAT -> AGTAAGGGATA
ACGGCAATGCG -> CGGCAATGCGG
CGGGTGGCGCC -> GGGTGGCGCCT
ACGGGAGAATC -> CGGGAGAATCC
ATAGTAGAAGC -> TAGTAGAAGCA
TCGTAAGTGTG -> CGTAAGTGTGG
GCTCCGTGTAT -> CTCCGTGTATA
CGTGCCCATTG -> GTGCCCATTGG
CCTACGTATGA -> CTACGTATGAA
CTTACCGCATC -> TTACCGCATCC
TCGACACATCC -> CGACACATCCC
TTGTATTTCAA -> TGTATTTCAAC
GAGTCCCGGGA -> AGTCCCGGGAA
TGTGGACAAAG -> GTGGACAAAGT
CGGCAATGCGG -> GGCAATGCGGG
AGAGGGTGCGC -> GAGGGTGCGCG
TGTTCCGCACT -> GTTCCGCACTC
TTCCACAGTAC -> TCCACAGTACC
TCACCCCCTGA -> CACCCCCTGAA
TCCACAGTACC -> CCACAGTACCA
ACTGACTAAGG -> CTGACTAAGGA
TAACCCGGTAC -> AACCCGGTACG
ATATCGGGATC -> TATCGGGATCG
ACCCATTCCGA -> CCCATTCCGAG
TACCGCATCCA -> ACCGCATCCAA
GGGGTAAGTGC -> GGGTAAGTGCC
CTTCGACACAT -> TTCGACACATA
TAGATATACGA -> AGATATACGAC
CCAACATTTTA -> CAACATTTTAC
TACAAGAAAAC -> ACAAGAAAACA
AGGGGGCTGCT -> GGGGGCTGCTC
TTCACCCCCTG -> TCACCCCCTGA
TAGAACCATGT -> AGAACCATGTA
GTTCTTGTTGA -> TTCTTGTTGAC
ACTTACCCTTC -> CTTACCCTTCA
TCCGAAAGTCA -> CCGAAAGTCAG
GCAAGTCAGCT -> CAAGTCAGCTT
CCCCTGAAGAA -> CCCTGAAGAAT
ATCTTCCAACA -> TCTTCCAACAA
GAACCATGTAG -> AACCATGTAGA
ATTCTACGCAC -> TTCTACGCACC
GACTTCGACAC -> ACTTCGACACA
ACCAACCCTAC -> CCAACCCTACG
ATTGCAGCCTA -> TTGCAGCCTAT
TCAAACAGAAT -> CAAACAGAATC
ATACGCCGACT -> TACGCCGACTT
ACCCTTCATTT -> CCCTTCATTTG
AGCCCTACGAG -> GCCCTACGAGG
TAATAGTCGCC -> AATAGTCGCCG
CGTATGAATAG -> GTATGAATAGG
CGCGAACGCCG -> GCGAACGCCGG
CAAAACTGGGT -> AAAACTGGGTT
CTTGGATACCC -> TTGGATACCCG
TTTCACCCCCT -> TTCACCCCCTG
GAAGAGGCTAT -> AAGAGGCTATC
GACTCACTAGC -> ACTCACTAGCC
TTACTATACGC -> TACTATACGCG
CTTCGAAAACG -> TTCGAAAACGT
TGCTCAAACAG -> GCTCAAACAGT,GCTCAAACAGA
TCTTCAACCTC -> CTTCAACCTCC
GGGGGTGGACC -> GGGGTGGACCG
GCCCCGTTAAA -> CCCCGTTAAAG
CGCATAAAACT -> GCATAAAACTC
TTCAACCTCCC -> TCAACCTCCCT
CTGAAGAATAA -> TGAAGAATAAG
CACAGTACCAG -> ACAGTACCAGT
ATCGGCTTGGT -> TCGGCTTGGTA
TATCATTCCAC -> ATCATTCCACA
GGGTCACAGCG -> GGTCACAGCGA
GGGACAGGCAA -> GGACAGGCAAT
ACGATCCTACA -> CGATCCTACAC
TGCCAGCGTAT -> GCCAGCGTATA
CACATCCCTAG -> ACATCCCTAGG
ATGTCGCACTG -> TGTCGCACTGA
GGGCGGATGCT -> GGCGGATGCTA
AAAACATGTTC -> AAACATGTTCT
GGTAACACTAG -> GTAACACTAGA
GCTGAGCAATG -> CTGAGCAATGG
ACTGACTCACT -> CTGACTCACTA
AGTCAAATTGC -> GTCAAATTGCA
GGGTTCTTGTT -> GGTTCTTGTTG
CCTTGGAATGG -> CTTGGAATGGC
CCCTTCACTCC -> CCTTCACTCCT
TTTCAACGGAG -> TTCAACGGAGG
CGAATTCTACG -> GAATTCTACGC
GGGTAAGTGCC -> GGTAAGTGCCT
ATTAGGAGTGT -> TTAGGAGTGTA
TTATATCGGGA -> TATATCGGGAT
AATTAGGAGTG -> ATTAGGAGTGT
TGCGGGTGACG -> GCGGGTGACGA
GAACTGAGAAT -> AACTGAGAATC
GGGGTGGACCG -> GGGTGGACCGA
GTTTCACCCCC -> TTTCACCCCCT
TACCCTTCATT -> ACCCTTCATTT
AGTATGAAGGC -> GTATGAAGGCC
GGGATAGATCA -> GGATAGATCAC
CTGGGCAAGTA -> TGGGCAAGTAA
ATGTCGCGTCA -> TGTCGCGTCAG
GTCAGCTTTAA -> TCAGCTTTAAT
TGACTCGTATT -> GACTCGTATTA
CTTGGAATGGC -> TTGGAATGGCA
TTAAAAGTATC -> TAAAAGTATCA
TTCGCAGAAAG -> TCGCAGAAAGC
CAGGTGGGCGA -> AGGTGGGCGAG
CTATCCATTCG -> TATCCATTCGA
GTAAGTGCCTA -> TAAGTGCCTAT
TCAACTGGGCA -> CAACTGGGCAA
AATGTCGCGTC -> ATGTCGCGTCA
CTTAGAGGGGG -> TTAGAGGGGGC
TAACAGATCCC -> AACAGATCCCT
ACCTCGTCTCG -> CCTCGTCTCGG
CGCAGAAAGCA -> GCAGAAAGCAC
TGAGAATCGTG -> GAGAATCGTGT
GACGGTAAGGG -> ACGGTAAGGGG
TGACTTCGACA -> GACTTCGACAC
ACCCAAATTTG -> CCCAAATTTGA
TAGGCCTTGTG -> AGGCCTTGTGC
GATCACCTTGG -> ATCACCTTGGA
GGAATGTCGCG -> GAATGTCGCGT
GAGCGGGACAG -> AGCGGGACAGG
CTCATTTGAAT -> TCATTTGAATG
TGTCGTAAGTG -> GTCGTAAGTGT
GGGCTGCTCTC -> GGCTGCTCTCG
GTCATTTAATT -> TCATTTAATTG
TGCTAGTCGAA -> GCTAGTCGAAT
TTAGGAGTGTA -> TAGGAGTGTAT
GGATCACCATT -> GATCACCATTT
TCTCACCCGTA -> CTCACCCGTAA
AACTATCCATT -> ACTATCCATTC
CGTCGTGCACG -> GTCGTGCACGT
CGGGAACGGCA -> GGGAACGGCAG
AGGGTAACAGA -> GGGTAACAGAT
GCACCCTCTTA -> CACCCTCTTAT
TGGCAGTTGCT -> GGCAGTTGCTG
TTGAGCGTGCA -> TGAGCGTGCAA
ATGGGATCACC -> TGGGATCACCA
GGATGATGAAA -> GATGATGAAAG
TAAGGGGTAAG -> AAGGGGTAAGT
ATCACCTTGGA -> TCACCTTGGAA
CATCCCTAGGG -> ATCCCTAGGGT
CTCCCAAACTA -> TCCCAAACTAA
GACGATCCTAC -> ACGATCCTACA
ATTTTAATTGG -> TTTTAATTGGG
CATTTGGAATG -> ATTTGGAATGT
AACGCCACCCA -> ACGCCACCCAT
TGCTCCCAAAC -> GCTCCCAAACT
AAGTGCCTATG -> AGTGCCTATGG
GTTTGCTCCGA -> TTTGCTCCGAC
TGGGCCCCAAT -> GGGCCCCAATT
GAAGCACACCT -> AAGCACACCTC
GAATAAGGGTT -> AATAAGGGTTG
TGAAGAATAAG -> GAAGAATAAGG
TAGTACGTGGT -> AGTACGTGGTG
ATTGGACATTT -> TTGGACATTTA
AATTGCCAGTA -> ATTGCCAGTAA
TTCGACACATA -> TCGACACATAC
AATTGCAGCCT -> ATTGCAGCCTA
GGATCGTTTGT -> GATCGTTTGTG
GTGCTCCGTGT -> TGCTCCGTGTA
CGGGTTAAAAT -> GGGTTAAAATT
AACAGATCCCT -> ACAGATCCCTG
AAAACTGGGTT -> AAACTGGGTTA
GGGTTAAGTCA -> GGTTAAGTCAA
ATTTTAGTATG -> TTTTAGTATGA
ACACATACAGG -> CACATACAGGT
CGAATTTTACT -> GAATTTTACTT
TGATCCTGATC -> GATCCTGATCC
CGTGCACGTAG -> GTGCACGTAGT
ACGAGCGGGAC -> CGAGCGGGACA
CGTTTGTGTGC -> GTTTGTGTGCT
TGGTTGCTCAA -> GGTTGCTCAAA
TTCGCCTGATG -> TCGCCTGATGT
GGCTATCCTTC -> GCTATCCTTCG
ATTTGGTATTA -> TTTGGTATTAT
TTTAGAGACCT -> TTAGAGACCTC
AAGCCATATAG -> AGCCATATAGT
CACGTTCTAAC -> ACGTTCTAACC
TAGAGGGGGCT -> AGAGGGGGCTG
AACCATGTAGA -> ACCATGTAGAT
GGGTTAAAATT -> GGTTAAAATTA
CACCCTCTTAT -> ACCCTCTTATG
CTACACCTATT -> TACACCTATTT
ACAGTGAGGTG -> CAGTGAGGTGT
ATTGCTCGGAT -> TTGCTCGGATG
AAACTCGGGGC -> AACTCGGGGCT
ACATTTACTAT -> CATTTACTATA
CCCTAACTGAT -> CCTAACTGATC
GCTATTTCGCA -> CTATTTCGCAG
TCCCTTCCTCG -> CCCTTCCTCGT
CGAGCGATCTT -> GAGCGATCTTC
ACCCTCTTATG -> CCCTCTTATGG
CGCACTCGCAT -> GCACTCGCATA
ATAGAACCATG -> TAGAACCATGT
TAAGGGACTTA -> AAGGGACTTAC
AAACGGGGCTG -> AACGGGGCTGA
ATAAAACTCGG -> TAAAACTCGGG
CTCGTCTCGGC -> TCGTCTCGGCG
AGACATTCTTG -> GACATTCTTGA
TGAACGCCACC -> GAACGCCACCC
TCACTAGCCTC -> CACTAGCCTCA
AATTTGAGTGA -> ATTTGAGTGAG
GGACAGGCAAT -> GACAGGCAATT
ACCATTTGGAC -> CCATTTGGACA
TGGGGTGCCGT -> GGGGTGCCGTT
GGTGATTGTAT -> GTGATTGTATT
CTCAAACAGTC -> TCAAACAGTCT
GATCCTACACC -> ATCCTACACCT
GATTGCCATCG -> ATTGCCATCGC
ACTGAGAATCG -> CTGAGAATCGT
GTTCCGCACTC -> TTCCGCACTCG
TAGTAGAAGCA -> AGTAGAAGCAC
GTATTTCAACG -> TATTTCAACGG
GATGATGAAAG -> ATGATGAAAGC
GATGGTTATGG -> ATGGTTATGGG
GTAAGGGGTAA -> TAAGGGGTAAG
TCAAACAGTCT -> CAAACAGTCTT
GGCCGTTTCAC -> GCCGTTTCACC
GGTGGCACGTT -> GTGGCACGTTC
TAAGTGCCTAT -> AAGTGCCTATG
CCTGAAGAATA -> CTGAAGAATAA
TAGCCTCATTT -> AGCCTCATTTG
GAGACCTCTGC -> AGACCTCTGCT
GTAAGGGATAG -> TAAGGGATAGA
GTAGATGGCCG -> TAGATGGCCGT
TGGGTTTCAAC -> GGGTTTCAACT
CAACGGAGGGT -> AACGGAGGGTT
ATGAATCGGCT -> TGAATCGGCTT
ACGTCCTAATA -> CGTCCTAATAG
GCCTCATTTGA -> CCTCATTTGAA
CGGGGCTTGGA -> GGGGCTTGGAT
ACTATACGCGA -> CTATACGCGAA
GCGCACGGGAG -> CGCACGGGAGA
CAGGCTCCCTT -> AGGCTCCCTTC
AGAACCTCACA -> GAACCTCACAT
CAGCGCCCCGT -> AGCGCCCCGTT
GTCCCGGGAAC -> TCCCGGGAACG
TTTGTGTTCTA -> TTGTGTTCTAA
AAAGTATGAAG -> AAGTATGAAGG
GACTCGTATTA -> ACTCGTATTAT
AGTAGGTCCAC -> GTAGGTCCACT
TATAGAACCAT -> ATAGAACCATG
GCGTCAGATAA -> CGTCAGATAAT
TACGACGGTAA -> ACGACGGTAAG
AACTGGGTTAA -> ACTGGGTTAAG
TAAGGATTTGG -> AAGGATTTGGT
TTATGGTGCTC -> TATGGTGCTCA
AAAAAACTATC -> AAAAACTATCC
CACAGCGAGCG -> ACAGCGAGCGC
TGCCGTTGAGA -> GCCGTTGAGAG
ACAAAGTACCG -> CAAAGTACCGC
GGCCTTGTGCC -> GCCTTGTGCCC
ACATACAGGTG -> CATACAGGTGG
CGGTCTTGGAT -> GGTCTTGGATC
TATACGCGAAC -> ATACGCGAACG
GACGCTTGTGG -> ACGCTTGTGGG
AGGACATTAAT -> GGACATTAATA
CGCGTCAGATA -> GCGTCAGATAA
ACTATAGAACC -> CTATAGAACCA
CCAATTATTCG -> CAATTATTCGA
TGCTATTTCGC -> GCTATTTCGCA
GCTTACCTGCT -> CTTACCTGCTC
GGTGCCGTTGA -> GTGCCGTTGAG
CAAGAAAACAT -> AAGAAAACATG
AAGGGACTTAC -> AGGGACTTACC
GACACATACAG -> ACACATACAGG
TGCCCATTGGT -> GCCCATTGGTT
GGATATGCAGG -> GATATGCAGGG
CCTAATAGTAG -> CTAATAGTAGA
CATCTGTCCTC -> ATCTGTCCTCT
TGAGCGTGCAA -> GAGCGTGCAAT
CTGGGTTAAGT -> TGGGTTAAGTC
TTTACGCGCAC -> TTACGCGCACG
ATAAGGGTTGG -> TAAGGGTTGGG
AATTCGTTGTT -> ATTCGTTGTTT
CCCGTTAAAGA -> CCGTTAAAGAA
TGGTTATGGGA -> GGTTATGGGAT
AATCCTGCAAA -> ATCCTGCAAAT
GCCAATCGTGT -> CCAATCGTGTG
GCAGTGCTCCG -> CAGTGCTCCGT
AAACAGTCTTG -> AACAGTCTTGC
TCGTGTGAAGA -> CGTGTGAAGAC
GTATAGCCTTA -> TATAGCCTTAA
GCAATTGCCAG -> CAATTGCCAGT
TTTTAGTGGAT -> TTTAGTGGATA
AGAATCCATGA -> GAATCCATGAC
CGATCTTCAAC -> GATCTTCAACC
TGTTCTGGACG -> GTTCTGGACGA
CCACTGACTTG -> CACTGACTTGA
GTCTCGCTTAC -> TCTCGCTTACC
TGCACGTAGTA -> GCACGTAGTAG
CAGGGATAGAT -> AGGGATAGATA
AAAACGTCCTA -> AAACGTCCTAA
GGGCTTGGATA -> GGCTTGGATAC
GGGTTTGCTCC -> GGTTTGCTCCG
GCTGTTCCGCA -> CTGTTCCGCAC
ATTTCAGCGCC -> TTTCAGCGCCC
AGTGTGGACAA -> GTGTGGACAAA
CCGTTGAGAGG -> CGTTGAGAGGG
CCTTGTGCCCT -> CTTGTGCCCTT
TGCCGGTATTT -> GCCGGTATTTC
CATTTAATTGG -> ATTTAATTGGA
ATCCCTGGCAT -> TCCCTGGCATC
TGCGCGGAAAT -> GCGCGGAAATT
CATATAGTTGC -> ATATAGTTGCC
TTGGGATTGGG -> TGGGATTGGGC
CAGCCAATCGT -> AGCCAATCGTG
AGGGTTGGGTT -> GGGTTGGGTTT
CTCGTGCCCAT -> TCGTGCCCATT
ACTCGGGGCTT -> CTCGGGGCTTG
CAGAAAGCACG -> AGAAAGCACGA
TGTCCTCTAGG -> GTCCTCTAGGT
ACTAATCATCT -> CTAATCATCTG
CGCTGAGGACA -> GCTGAGGACAT
ACATTGCTCGG -> CATTGCTCGGA
AGTAGAAGCAC -> GTAGAAGCACA
TATCCATTCGA -> ATCCATTCGAG
AGTCAGCTTTA -> GTCAGCTTTAA
TAGGGTAACAG -> AGGGTAACAGA
TCTGTATGCTG -> CTGTATGCTGC
AGTCGAATTTT -> GTCGAATTTTA
CATTTGAATGA -> ATTTGAATGAC
TATAGGGACGA -> ATAGGGACGAC
CGTGTGCCAAC -> GTGTGCCAACA
TTTTAATTGGG -> TTTAATTGGGA
TGAAAGCCATA -> GAAAGCCATAT
GCCAGTAAGGG -> CCAGTAAGGGA
ACGTAGTAGGT -> CGTAGTAGGTC
CACATACAGGT -> ACATACAGGTG
GCTCTCGGGTT -> CTCTCGGGTTC
TCGGATGGATG -> CGGATGGATGA
TTGCTCAAACA -> TGCTCAAACAG
CACACCTCGTC -> ACACCTCGTCT
TGCCCTTCGAA -> GCCCTTCGAAA
GACGTTCTAGG -> ACGTTCTAGGT
CAGGCTAGGCC -> AGGCTAGGCCT
TGTGTGCTGAG -> GTGTGCTGAGC
TATGAAGGCCC -> ATGAAGGCCCG
GGAGTCCCGGG -> GAGTCCCGGGA
CCGGGAACGGC -> CGGGAACGGCA
TTTGAATGACG -> TTGAATGACGC
ATTTCGCAGCC -> TTTCGCAGCCA
GGAACTGCCAC -> GAACTGCCACT
AGTCAGACGCT -> GTCAGACGCTA
CTGACTAAGGA -> TGACTAAGGAT
CTGATCCCTTC -> TGATCCCTTCC
GTGCTCAAACA -> TGCTCAAACAG
GGGGCTGCTCT -> GGGCTGCTCTC
ATATTTTGTGT -> TATTTTGTGTT
CGCCGGACTAC -> GCCGGACTACG
ACTGGGTTAAG -> CTGGGTTAAGT
AGTTGAGCGTG -> GTTGAGCGTGC
CCTACACCTAT -> CTACACCTATT
ATAGCCTTAAA -> TAGCCTTAAAA
CGCTTGTGGGG -> GCTTGTGGGGG
GTACGTGGTGA -> TACGTGGTGAT
CTGACATTGCT -> TGACATTGCTC
TAAAAGTAACA -> AAAAGTAACAG
AGAGGCTATCC -> GAGGCTATCCT
CACTGACTCGT -> ACTGACTCGTA
TCCTCTAGGTA -> CCTCTAGGTAA
AATAACCGGAA -> ATAACCGGAAG
ACCTCTGCTCC -> CCTCTGCTCCC
AGGTGGGCGAG -> GGTGGGCGAGG
GGATACCCGGG -> GATACCCGGGC
ATTCCACAGTA -> TTCCACAGTAC
GAGAATCGTGT -> AGAATCGTGTG
AGTCGCCGCTG -> GTCGCCGCTGA
TATTCGACACA -> ATTCGACACAT
ACTCGTATTAT -> CTCGTATTATA
TTCCAACAAAA -> TCCAACAAAAC
TAATAGTAGAA -> AATAGTAGAAG
TATGCAGGGAT -> ATGCAGGGATA
ATCCCTTCCTC -> TCCCTTCCTCG
TTCTAAAGTAT -> TCTAAAGTATG
ATGGTGCTCAA -> TGGTGCTCAAA
AGGGACGACTA -> GGGACGACTAT
AACCGTCTCGC -> ACCGTCTCGCT
TCGATTTAGAG -> CGATTTAGAGA
ACGACGTTCTA -> CGACGTTCTAG
TGGTATCATGG -> GGTATCATGGG
AAGTAAGGGAC -> AGTAAGGGACT
TCCAACAAAAC -> CCAACAAAACT
GAATCGTGTGC -> AATCGTGTGCC
AAGGGCTCACT -> AGGGCTCACTA
ATAGGAAAAAA -> TAGGAAAAAAC
CAATGGGCCCC -> AATGGGCCCCA
GTGAGGTGTTG -> TGAGGTGTTGG
TAACTGATCCT -> AACTGATCCTG
TTAATTGGGAT -> TAATTGGGATT
ACGGAGGGTTT -> CGGAGGGTTTG
TTTTCCTGTAG -> TTTCCTGTAGC
GTCGCCGCTGA -> TCGCCGCTGAG
TGAGAGGGTGC -> GAGAGGGTGCG
AGGCCCGCAGT -> GGCCCGCAGTG
TTGGATACCCG -> TGGATACCCGG
CGGTAAGGGGT -> GGTAAGGGGTA
TCGCAGCCAAT -> CGCAGCCAATC
ATTTCAACGGA -> TTTCAACGGAG
CCGGATGGGAG -> CGGATGGGAGT
AAAGTACCGCT -> AAGTACCGCTA
CCAGTGTCGTA -> CAGTGTCGTAA
TGATGTCGCAC -> GATGTCGCACT
ACATTAATAAC -> CATTAATAACC
CCGTTAAAGAA -> CGTTAAAGAAC
AGCCTATGAAA -> GCCTATGAAAC
GGTGCGCGGAA -> GTGCGCGGAAA
TCTCGGGTTCT -> CTCGGGTTCTT
TAACCGTCTCG -> AACCGTCTCGC
GGATAGTACGT -> GATAGTACGTG
TTTGGACACAC -> TTGGACACACT
CGGATGGATGA -> GGATGGATGAT
TTGTGGGGGTG -> TGTGGGGGTGG
TATCAACAGGG -> ATCAACAGGGT
TCCCTTCACTC -> CCCTTCACTCC
TGCTCGGATGG -> GCTCGGATGGA
GAGCGTGCAAT -> AGCGTGCAATA
AATGCGGGTGA -> ATGCGGGTGAC
TCCGACTGTCT -> CCGACTGTCTC
CCATTCGAGCG -> CATTCGAGCGA
TATGTAACTGA -> ATGTAACTGAC
GCCGGACTACG -> CCGGACTACGA
CTGTATGCTGC -> TGTATGCTGCT
GCAAGTAAGGG -> CAAGTAAGGGA
TGGTGCTCAAA -> GGTGCTCAAAC
CTCGTATTATA -> TCGTATTATAT
GCCAGCGTATA -> CCAGCGTATAG
ACTCACTAGCC -> CTCACTAGCCT
TAGGATAGTAC -> AGGATAGTACG
TCTAGGTGGCA -> CTAGGTGGCAC
GGGATTGGGCA -> GGATTGGGCAA
AGGGTGCGCGG -> GGGTGCGCGGA
ATTACTATAAG -> TTACTATAAGT
TATCCTTCGCA -> ATCCTTCGCAG
ATTTGAGTGAG -> TTTGAGTGAGA
GGACTTTTCCT -> GACTTTTCCTG
TCTAAAGTATG -> CTAAAGTATGA
CACTCGCATAA -> ACTCGCATAAA
CCTTCCTCGTG -> CTTCCTCGTGC
GACTTAGAGGG -> ACTTAGAGGGG
AGCGATCTTCA -> GCGATCTTCAA
TGGACATTTAC -> GGACATTTACT
AATGACTTCGA -> ATGACTTCGAC
TTTGGAATGTC -> TTGGAATGTCG
CCAGTCATTTA -> CAGTCATTTAA
ACTCGCATAAA -> CTCGCATAAAA
AGCACGACGTT -> GCACGACGTTC
TTGGATCGGAA -> TGGATCGGAAA
GCGGGACAGGC -> CGGGACAGGCA
GTCAATTGTCA -> TCAATTGTCAG
GCTCAAACAGT -> CTCAAACAGTC
GGAGGGTTTGC -> GAGGGTTTGCT
AGATCCCTGGC -> GATCCCTGGCA
CGCCCCGTTAA -> GCCCCGTTAAA
GTTCTAAAGTA -> TTCTAAAGTAT
GAGGGTTTGCT -> AGGGTTTGCTC
CGAGGAACTGC -> GAGGAACTGCC
ACCCGTAATCT -> CCCGTAATCTT
ACAGTACCAGT -> CAGTACCAGTG
GGTTAAGTCAA -> GTTAAGTCAAA
AGGTCCACTGC -> GGTCCACTGCC
GCACGGGAGAA -> CACGGGAGAAT
CCTAACCGTCT -> CTAACCGTCTC
GTCGCACTGAC -> TCGCACTGACT
TCGTTTGTGTG -> CGTTTGTGTGC
ATTTAGAGACC -> TTTAGAGACCT
GCCAACCCAAA -> CCAACCCAAAT
GGAATATTTTG -> GAATATTTTGT
ACTCCTCTAAT -> CTCCTCTAATA
AACCAATGACT -> ACCAATGACTT
GTATAGGGACG -> TATAGGGACGA
AGTATCAACAG -> GTATCAACAGG
GAATTTTACTT -> AATTTTACTTC
TGACTAAGGAT -> GACTAAGGATT
TCCTGCAAATT -> CCTGCAAATTA
CACCTATTTTA -> ACCTATTTTAG
GGGTTTCAACT -> GGTTTCAACTG
GCCACTGACTT -> CCACTGACTTG
TAGTAGGTCCA -> AGTAGGTCCAC
CCAACAAAACT -> CAACAAAACTG
TCAACCTCCCT -> CAACCTCCCTC
TTTCGCAGCCA -> TTCGCAGCCAA
GCTGCTCTCGG -> CTGCTCTCGGG
GCTCCAAGCCC -> CTCCAAGCCCT
TTTGCTCCGAC -> TTGCTCCGACT
GACCGAATTCT -> ACCGAATTCTA
TCAACGGAGGG -> CAACGGAGGGT
ATTATAATCGC -> TTATAATCGCG
GTGGGGGTGGA -> TGGGGGTGGAC
ACATTTTACGC -> CATTTTACGCG
CTATCCCAGTC -> TATCCCAGTCA
CCTCATTTGAA -> CTCATTTGAAT
GAAAACGTCCT -> AAAACGTCCTA
CAGTTGTATGG -> AGTTGTATGGC
TTATGGGATCA -> TATGGGATCAC
TTTAATTGGGA -> TTAATTGGGAT
GAATGTCGCGT -> AATGTCGCGTC
GCTTTAATTAC -> CTTTAATTACT
AACCCGGTACG -> ACCCGGTACGG
GTGGCACGTTC -> TGGCACGTTCT
GCCATATAGTT -> CCATATAGTTG
GCCGCTGAGGA -> CCGCTGAGGAC
GTGATTGTATT -> TGATTGTATTT
TATCTGTATGC -> ATCTGTATGCT
CCCTCTTATGG -> CCTCTTATGGT
GCTTGGATACC -> CTTGGATACCC
TTCTAGGTGGC -> TCTAGGTGGCA
ATTGGGATTGG -> TTGGGATTGGG
GCGTATAGCCT -> CGTATAGCCTT
CTCAAACAGAA -> TCAAACAGAAT
TCGGTCTTGGA -> CGGTCTTGGAT
GCAGACCAACC -> CAGACCAACCC
GACATTTACTA -> ACATTTACTAT
CTACGAGGTCA -> TACGAGGTCAA
ATATGGTAACA -> TATGGTAACAC
TATTTTAGTAT -> ATTTTAGTATG
TACGACTGACT -> ACGACTGACTA
CTCCGTGTATA -> TCCGTGTATAG
TCCCAGTCATT -> CCCAGTCATTT
CAATACGTCCC -> AATACGTCCCT
TAGGTAACCCC -> AGGTAACCCCC
CGACTGACTAA -> GACTGACTAAG
GATATGCAGGG -> ATATGCAGGGA
AGTGCTCCGTG -> GTGCTCCGTGT
GTGGGCGAGGA -> TGGGCGAGGAA
TACCCGGGCAA -> ACCCGGGCAAA
CCCGCAGTGCT -> CCGCAGTGCTC
CTATAGAACCA -> TATAGAACCAT
TCCTGTAGCGA -> CCTGTAGCGAG
GAATAGGATAG -> AATAGGATAGT
ACGCCGACTTA -> CGCCGACTTAG
CGGACTACGAC -> GGACTACGACG
ACGGTAAGGGG -> CGGTAAGGGGT
ATAATTCGTTG -> TAATTCGTTGT
TACTATAAGTT -> ACTATAAGTTG
CTCTTATGGTG -> TCTTATGGTGC
AAATTTGAGTG -> AATTTGAGTGA
AGCGAGTGGGT -> GCGAGTGGGTC
ACTAGATGGTT -> CTAGATGGTTA
CCCCGCTGTAG -> CCCGCTGTAGG
AATTGTCAGGC -> ATTGTCAGGCT
CGTCTCGGCGG -> GTCTCGGCGGG
GTTATGGGATC -> TTATGGGATCA
TCCTAATAGTA -> CCTAATAGTAG
CCGTTTCACCC -> CGTTTCACCCC
GTACCAGTGTC -> TACCAGTGTCG
TTCAGGCTAGG -> TCAGGCTAGGC
GTTTTAGTGGA -> TTTTAGTGGAT
TCTAATAGTCG -> CTAATAGTCGC
GGTAAGTGCCT -> GTAAGTGCCTA
CCTGGCATCAT -> CTGGCATCATA
GTGCAATACGT -> TGCAATACGTC
CGACACATCCC -> GACACATCCCT
TGGGCATTTCA -> GGGCATTTCAG
CGTATAGCCTT -> GTATAGCCTTA
ATCATCTGTCC -> TCATCTGTCCT
TCGTGTGCCAA -> CGTGTGCCAAC
CGGGAGAATCC -> GGGAGAATCCA
CGGGTGACGAT -> GGGTGACGATC
AGTCTTGCTCG -> GTCTTGCTCGA
AGGAAAAAACT -> GGAAAAAACTA
GACACACTCGG -> ACACACTCGGG
CGGGGAATATT -> GGGGAATATTT
CTCCGACTGTC -> TCCGACTGTCT
GAACTGCCACT -> AACTGCCACTG
CTTCGCAGAAA -> TTCGCAGAAAG
AGTGAGGTGTT -> GTGAGGTGTTG
GACACATCCCT -> ACACATCCCTA
AAACAGAATCC -> AACAGAATCCT
TGGGAGTCCCG -> GGGAGTCCCGG
CTGACTCACTA -> TGACTCACTAG
ATAGGGACGAC -> TAGGGACGACT
GGTCAATTGTC -> GTCAATTGTCA
ACTAAGGATTT -> CTAAGGATTTG
AAAGCCATATA -> AAGCCATATAG
TGAGCAATGGG -> GAGCAATGGGC
TAATAACCGGA -> AATAACCGGAA
GGGTGGCGCCT -> GGTGGCGCCTA
AAGGATTTGGT -> AGGATTTGGTA
AGAAAACATGT -> GAAAACATGTT
AATGACGCAGC -> ATGACGCAGCT
TATTATGTAAC -> ATTATGTAACT
TGCCAGTAAGG -> GCCAGTAAGGG
CTCGGGGCTTG -> TCGGGGCTTGG
TCACTCCTCTA -> CACTCCTCTAA
AGCAGTTGTAT -> GCAGTTGTATG
TTAATTGGACA -> TAATTGGACAT
TACCTGCTCCA -> ACCTGCTCCAA
TGCCAACCCAA -> GCCAACCCAAA
TGTTGACGCTT -> GTTGACGCTTG
AAATTAGGAGT -> AATTAGGAGTG
GTCCTAATAGT -> TCCTAATAGTA
CGGAGGGTTTG -> GGAGGGTTTGC
CGTTAAAGAAC -> GTTAAAGAACC
AAACTATCCAT -> AACTATCCATT
TTCTGGACGAG -> TCTGGACGAGC
CCTTAAAAGTA -> CTTAAAAGTAT
GAAAGTCAGAC -> AAAGTCAGACG
GACGAGCGGGA -> ACGAGCGGGAC
CAATGCGGGTG -> AATGCGGGTGA
TTTAATTACTA -> TTAATTACTAT
TCCATTCGAGC -> CCATTCGAGCG
CAGATAATTCG -> AGATAATTCGT
GGCGGGTTAAA -> GCGGGTTAAAA
TTCAACTGGGC -> TCAACTGGGCA
GTTTGTGTGCT -> TTTGTGTGCTG
TCGAACTGAGA -> CGAACTGAGAA
CGCCGCTGAGG -> GCCGCTGAGGA
ATCCTTCGCAG -> TCCTTCGCAGA
GCAGCCAATCG -> CAGCCAATCGT
GAACGGGGGGC -> AACGGGGGGCG
AATTCTACGCA -> ATTCTACGCAC
TGACGATCCTA -> GACGATCCTAC
AGTATGAATCG -> GTATGAATCGG
ATGCGGGTGAC -> TGCGGGTGACG
CTTGGATCGGA -> TTGGATCGGAA
GGGCCCCAATT -> GGCCCCAATTA
TGAATCGGCTT -> GAATCGGCTTG
GGGGCTGACAT -> GGGCTGACATT
AAGTATCAACA -> AGTATCAACAG
CGACGTTCTAG -> GACGTTCTAGG
ATCGGGATCGT -> TCGGGATCGTT
ACATCCCTAGG -> CATCCCTAGGG
TTTACTTCTGC -> TTACTTCTGCC
GTATTATATCG -> TATTATATCGG
GGTATTATGTA -> GTATTATGTAA
TCTTGGATCGG -> CTTGGATCGGA
CTCCTCTAATA -> TCCTCTAATAG
TCCTTCGCAGA -> CCTTCGCAGAA
TCGCATAAAAC -> CGCATAAAACT
TCAGGCTCCCT -> CAGGCTCCCTT
TAGTCGAATTT -> AGTCGAATTTT
GTCGTGCACGT -> TCGTGCACGTA
CTTGTGGGGGT -> TTGTGGGGGTG
CTCGGGTGGCG -> TCGGGTGGCGC
CTAAGGATTTG -> TAAGGATTTGG
CGCTATCATTC -> GCTATCATTCC
CACTGACTTGA -> ACTGACTTGAA
GGTTCTTGTTG -> GTTCTTGTTGA
ACGTTCTAACC -> CGTTCTAACCC
GGAAGAGGCTA -> GAAGAGGCTAT
GACTTACCCTT -> ACTTACCCTTC
GCTACAAGAAA -> CTACAAGAAAA
AACGGCAGACC -> ACGGCAGACCA
GTTGGGTTTCA -> TTGGGTTTCAA
CACCATTTGGA -> ACCATTTGGAC
TTTAATTGGAC -> TTAATTGGACA
CCGAATTCTAC -> CGAATTCTACG
CAGTCTTGCTC -> AGTCTTGCTCG
GTGGCGCCTAA -> TGGCGCCTAAC
ATTGGTTGCTC -> TTGGTTGCTCA
ACCGCATCCAA -> CCGCATCCAAA
TATGGGGTGCC -> ATGGGGTGCCG
CCTCGTGCCCA -> CTCGTGCCCAT
ATAACCGGAAG -> TAACCGGAAGA
TCCAAGCCCTA -> CCAAGCCCTAC
CATGTAGATAA -> ATGTAGATAAA
CTTCACTCCTC -> TTCACTCCTCT
CCGGTACGGCA -> CGGTACGGCAA
GTGTATCTGTA -> TGTATCTGTAT
GATACCCGGGC -> ATACCCGGGCA
TCGGCTTGGTA -> CGGCTTGGTAT
TTGTGCCCTTC -> TGTGCCCTTCG
CGTGTATAGGG -> GTGTATAGGGA
CTGGCATCATA -> TGGCATCATAG
GTGCGCGGAAA -> TGCGCGGAAAT
TCGGGTTCTTG -> CGGGTTCTTGT
TCTAGGTAACC -> CTAGGTAACCC
TGATTGTATTT -> GATTGTATTTC
CCCATTGGTTG -> CCATTGGTTGC
CATCCAAAAGG -> ATCCAAAAGGG
GGTATCATGGG -> GTATCATGGGC
ATGGTTATGGG -> TGGTTATGGGA
CTTATGGTGCT -> TTATGGTGCTC
ATCTGTCCTCT -> TCTGTCCTCTA
GCGGAAATTTT -> CGGAAATTTTA
TGTATTTCAAC -> GTATTTCAACG
TATTATATCGG -> ATTATATCGGG
GTCCACTGCCA -> TCCACTGCCAG
AGCACACCTCG -> GCACACCTCGT
GATAAAAGTAA -> ATAAAAGTAAC
TATGAATAGGA -> ATGAATAGGAT
GAGAGGGTGCG -> AGAGGGTGCGC
GTTTTCGCCTG -> TTTTCGCCTGA
TAGATAAAAGT -> AGATAAAAGTA
ACCCCCTGAAG -> CCCCCTGAAGA
GGTGTTGGAAT -> GTGTTGGAATC
GATTTGGTATT -> ATTTGGTATTA
ATCGAACTGAG -> TCGAACTGAGA
TTCCGCACTCG -> TCCGCACTCGC
TCGCACTGACT -> CGCACTGACTC
TGTCTCGGTCT -> GTCTCGGTCTT
CGCAGCCAATC -> GCAGCCAATCG
GTGACGATCCT -> TGACGATCCTA
GCAGTTGCTGT -> CAGTTGCTGTT
CAAATTGCAGC -> AAATTGCAGCC
GGCCCCAATTA -> GCCCCAATTAT
GAATCGGCTTG -> AATCGGCTTGG
GCAGGGATAGA -> CAGGGATAGAT
TTAGTATGAAT -> TAGTATGAATC
ATGAAACGGGG -> TGAAACGGGGC
CATGTTCTGGA -> ATGTTCTGGAC
TGGACACACTC -> GGACACACTCG
CTAGGTAACCC -> TAGGTAACCCC
TAATTGGACAT -> AATTGGACATT
CCTGATCCCTT -> CTGATCCCTTC
GAGGTCAATTG -> AGGTCAATTGT
CAAAGTACCGC -> AAAGTACCGCT
GGACACACTCG -> GACACACTCGG
ACACTCGGGTG -> CACTCGGGTGG
TCACTATAGAA -> CACTATAGAAC
CACTATAGAAC -> ACTATAGAACC
GTGCCTATGGG -> TGCCTATGGGG
GCACTGACTCG -> CACTGACTCGT
TTCGAAAACGT -> TCGAAAACGTC
TCGGGTGGCGC -> CGGGTGGCGCC
GACTGACTAAG -> ACTGACTAAGG
TGGGCGAGGAA -> GGGCGAGGAAC
CCCTACGTATG -> CCTACGTATGA
AGTAAGGGATA -> GTAAGGGATAG
GGTTAAAATTA -> GTTAAAATTAG
TGTTTTCGCCT -> GTTTTCGCCTG
ATGGGCATTTC -> TGGGCATTTCA
GTCTCGGCGGG -> TCTCGGCGGGT
GGGTGCGCGGA -> GGTGCGCGGAA
ACCGTCTCGCT -> CCGTCTCGCTT
AATATGGTAAC -> ATATGGTAACA
TACAGGTGGGC -> ACAGGTGGGCG
ATCCATGACCC -> TCCATGACCCA
GATCTTCAACC -> ATCTTCAACCT
CCAAAAGGGCT -> CAAAAGGGCTC
AAAGTATCAAC -> AAGTATCAACA
AGCGGGACAGG -> GCGGGACAGGC
ATCTGTATGCT -> TCTGTATGCTG
GTATGAATCGG -> TATGAATCGGC
GGTAGATGGCC -> GTAGATGGCCG
TTCTACGCACC -> TCTACGCACCC
CTAGGTGGCAC -> TAGGTGGCACG
GTACCGCTACA -> TACCGCTACAA
GGCGCTCGTTT -> GCGCTCGTTTT
GTACGGCAATG -> TACGGCAATGC
GTATCTGTATG -> TATCTGTATGC
GTCCTCTAGGT -> TCCTCTAGGTA
GGTGGGCGAGG -> GTGGGCGAGGA
AAGTTGAGCGT -> AGTTGAGCGTG
CCCAAATTTGA -> CCAAATTTGAG
GGTTCGCAGGA -> GTTCGCAGGAT
ACAGGGTAGAT -> CAGGGTAGATG
TGTGAAGACAT -> GTGAAGACATT
CTAATAGTAGA -> TAATAGTAGAA
TTGAATGACGC -> TGAATGACGCA
GTAACAGTGAG -> TAACAGTGAGG
TGCTCGATTTA -> GCTCGATTTAG
ACATTCTTGAA -> CATTCTTGAAC
TCGGGATCGTT -> CGGGATCGTTT
CCAAACTAATC -> CAAACTAATCA
AATTGGACATT -> ATTGGACATTT
AAGAAAACATG -> AGAAAACATGT
TCATTTAATTG -> CATTTAATTGG
GGCGGATGCTA -> GCGGATGCTAT
GGCAATGCGGG -> GCAATGCGGGT
CTTCAACCTCC -> TTCAACCTCCC
AGGTGGCACGT -> GGTGGCACGTT
TTAGTGGATAT -> TAGTGGATATG
GGAGTGTATCT -> GAGTGTATCTG
CACCCATTCCG -> ACCCATTCCGA
GGTCACAGCGA -> GTCACAGCGAG
ATACGACTGAC -> TACGACTGACT
GCTTACCGCAT -> CTTACCGCATC
ATCGTGTGCCA -> TCGTGTGCCAA
GAAATTTTAAT -> AAATTTTAATT
TAATTACTATA -> AATTACTATAA
TGGACCGAATT -> GGACCGAATTC
GACAAAGTACC -> ACAAAGTACCG
CGAGCTCGGAC -> GAGCTCGGACT
AAGGGGTAAGT -> AGGGGTAAGTG
CAACCTCCCTC -> AACCTCCCTCT
TCACCCGTAAT -> CACCCGTAATC
CACCGGATGGG -> ACCGGATGGGA
AGCTTACCGCA -> GCTTACCGCAT
TAGATGGCCGT -> AGATGGCCGTT
CGCTACAAGAA -> GCTACAAGAAA
CGGACTTTTCC -> GGACTTTTCCT
TTCGACACATC -> TCGACACATCC
CCTCTGCTCCC -> CTCTGCTCCCA
AGAAGCACACC -> GAAGCACACCT
ACTGCCAGCGT -> CTGCCAGCGTA
CTGCTAGTCGA -> TGCTAGTCGAA
ATGTTCTGGAC -> TGTTCTGGACG
AAACCAATGAC -> AACCAATGACT
AACGGGGGGCG -> ACGGGGGGCGG
TCGGAAAGCAG -> CGGAAAGCAGT
TGCCATCGCGG -> GCCATCGCGGG
CGGGCAAACCA -> GGGCAAACCAA
TGAAACGGGGC -> GAAACGGGGCT
GGCAAGTCAGC -> GCAAGTCAGCT
AGGCTCCCTTC -> GGCTCCCTTCA
GTGGGTCACAG -> TGGGTCACAGC
AGATAATTCGT -> GATAATTCGTT
CCCAAACTAAT -> CCAAACTAATC
TGTTCTAAAGT -> GTTCTAAAGTA
ATAAGTTGAGC -> TAAGTTGAGCG
CGCCTGATGTC -> GCCTGATGTCG
ATCACCATTTG -> TCACCATTTGG
CGCCGACTTAG -> GCCGACTTAGA
CAGGATCTCAC -> AGGATCTCACC
CCCGGGCAAAC -> CCGGGCAAACC
TGCTCCAAGCC -> GCTCCAAGCCC
AGAGACCTCTG -> GAGACCTCTGC
AACTGCCACTG -> ACTGCCACTGA
CACTAGCCTCA -> ACTAGCCTCAT
AACATTTTACG -> ACATTTTACGC
TATTTCGCAGC -> ATTTCGCAGCC
CTATACGCGAA -> TATACGCGAAC
CTCGGGTTCTT -> TCGGGTTCTTG
CATTTACTATA -> ATTTACTATAC
CTAACCGTCTC -> TAACCGTCTCG
AAAGTCAGACG -> AAGTCAGACGC
TCCCTCTAATA -> CCCTCTAATAT
CGAAAACGTCC -> GAAAACGTCCT
CGTTGTTTTCG -> GTTGTTTTCGC
GTAATCTTCCA -> TAATCTTCCAA
AGGGATAGATC -> GGGATAGATCA
TGGTATTATGT -> GGTATTATGTA
TGAATGACGCA -> GAATGACGCAG
TCCTCTAATAG -> CCTCTAATAGT
GTCACAGCGAG -> TCACAGCGAGC
TTGCTCGGATG -> TGCTCGGATGG
GTATTATGTAA -> TATTATGTAAC
AATCGTGTGAA -> ATCGTGTGAAG
TAGATGGTTAT -> AGATGGTTATG
GCACACCTCGT -> CACACCTCGTC
TGCAGGGATAG -> GCAGGGATAGA
GCGGGTGACGA -> CGGGTGACGAT
TGGACAAAGTA -> GGACAAAGTAC
CTCTAATAGTC -> TCTAATAGTCG
TTAGAGACCTC -> TAGAGACCTCT
CCCCCTGAAGA -> CCCCTGAAGAA
GCGTGCAATAC -> CGTGCAATACG
TAATCATCTGT -> AATCATCTGTC
CCCCGTTAAAG -> CCCGTTAAAGA
CAGGGTAGATG -> AGGGTAGATGG
ATTGGGCAAGT -> TTGGGCAAGTC
ACCTGCTCCAA -> CCTGCTCCAAG
CGTTCTAGGTG -> GTTCTAGGTGG
TCGGACTTTTC -> CGGACTTTTCC
AGTTGCCGGTA -> GTTGCCGGTAT
CAAAAGGGCTC -> AAAAGGGCTCA
CCAAGCCCTAC -> CAAGCCCTACG
GCAAACCAATG -> CAAACCAATGA
ATTTTACTTCT -> TTTTACTTCTG
AAGTCAGACGC -> AGTCAGACGCT
GGTTTCAACTG -> GTTTCAACTGG
AAAACTCGGGG -> AAACTCGGGGC
GCAATGGGCCC -> CAATGGGCCCC
TAGATCACCTT -> AGATCACCTTG
TATAAGTTGAG -> ATAAGTTGAGC
CCCACCGGATG -> CCACCGGATGG
ATGCTATTTCG -> TGCTATTTCGC
AATCCATGACC -> ATCCATGACCC
CCATATAGTTG -> CATATAGTTGC
GGCCCGCAGTG -> GCCCGCAGTGC
TGAAGGCCCGC -> GAAGGCCCGCA
ACCGCTACAAG -> CCGCTACAAGA
TCCCTGGCATC -> CCCTGGCATCA
GCCGTTTCACC -> CCGTTTCACCC
ACTATAAGTTG -> CTATAAGTTGA
GCCTTAAAAGT -> CCTTAAAAGTA
TAGAAGCACAC -> AGAAGCACACC
AAAAGGGCTCA -> AAAGGGCTCAC
AAAGTAACAGT -> AAGTAACAGTG
TCCGATTGCCA -> CCGATTGCCAT
AACACTAGATG -> ACACTAGATGG
CTGCCAACCCA -> TGCCAACCCAA
GGCAGACCAAC -> GCAGACCAACC
AACTGGGCAAG -> ACTGGGCAAGT
AAATTTTAATT -> AATTTTAATTG
TTGCTGTTCCG -> TGCTGTTCCGC
AAACATGTTCT -> AACATGTTCTG
ACTATCCCAGT -> CTATCCCAGTC
GAACGGCAGAC -> AACGGCAGACC
AGCGCCCCGTT -> GCGCCCCGTTA
CGTTGAGAGGG -> GTTGAGAGGGT
ACTTGAACGGG -> CTTGAACGGGG
TCGCAGGATCT -> CGCAGGATCTC
ATTCGAGCGAT -> TTCGAGCGATC
TTCTTGAACGC -> TCTTGAACGCC
AAAGGGCTCAC -> AAGGGCTCACT
TTAAGTCAAAT -> TAAGTCAAATT
TGCTGAGCAAT -> GCTGAGCAATG
GGTAAGGGGTA -> GTAAGGGGTAA
CCGCTGTAGGT -> CGCTGTAGGTT
ATCTCACCCGT -> TCTCACCCGTA
AATAGTCGCCG -> ATAGTCGCCGC
GGCTCCCTTCA -> GCTCCCTTCAC
TATAGCCTTAA -> ATAGCCTTAAA
TCGCTTACCTG -> CGCTTACCTGC
TATGGTAACAC -> ATGGTAACACT
CCAGCGTATAG -> CAGCGTATAGC
ATGGGAGTCCC -> TGGGAGTCCCG
CAGTGCTCCGT -> AGTGCTCCGTG
TACGTGGTGAT -> ACGTGGTGATT
ATCGTGTGAAG -> TCGTGTGAAGA
TCGCCTGATGT -> CGCCTGATGTC
AGAGGGGGCTG -> GAGGGGGCTGC
GATGGGAGTCC -> ATGGGAGTCCC
TGGACGAGCGG -> GGACGAGCGGG
GACATTAATAA -> ACATTAATAAC
CTATCCTTCGC -> TATCCTTCGCA
TGATGAAAGCC -> GATGAAAGCCA
TTAGAGGGGGC -> TAGAGGGGGCT
GAGTGAGATCG -> AGTGAGATCGA
TTACCGCATCC -> TACCGCATCCA
TGTAGATAAAA -> GTAGATAAAAG
GCCGGTATTTC -> CCGGTATTTCA
GGCTGACATTG -> GCTGACATTGC
CCCGCTGTAGG -> CCGCTGTAGGT
AGATGGCCGTT -> GATGGCCGTTT
GCAGAAAGCAC -> CAGAAAGCACG
TCTGGACGAGC -> CTGGACGAGCG
ATGAATAGGAT -> TGAATAGGATA
TGCAAATTATA -> GCAAATTATAA
TAAAGAACCTC -> AAAGAACCTCA
GTTAAGTCAAA -> TTAAGTCAAAT
ATATGCAGGGA -> TATGCAGGGAT
GCAGCTTACCG -> CAGCTTACCGC
TCTACGCACCC -> CTACGCACCCT
GGATGCTATTT -> GATGCTATTTC
CGTCAGATAAT -> GTCAGATAATT
GGGCTCACTAT -> GGCTCACTATA
TCTCGGCGGGT -> CTCGGCGGGTT
CCTCTAATAGT -> CTCTAATAGTC
GGGTTGGGTTT -> GGTTGGGTTTC
AATATTTTGTG -> ATATTTTGTGT
CTAGATGGTTA -> TAGATGGTTAT
CCCTTCATTTG -> CCTTCATTTGG
GGGAACGGCAG -> GGAACGGCAGA
ACAAGAAAACA -> CAAGAAAACAT
GGATCTCACCC -> GATCTCACCCG
ATAGATATACG -> TAGATATACGA
CTCGGCGGGTT -> TCGGCGGGTTA
TGTGCCCTTCG -> GTGCCCTTCGA
CCTACGAGGTC -> CTACGAGGTCA
CACTCCTCTAA -> ACTCCTCTAAT
CTGCCACTGAC -> TGCCACTGACT
TTGCCAGTAAG -> TGCCAGTAAGG
GGGATCGTTTG -> GGATCGTTTGT
GCCCTTCGAAA -> CCCTTCGAAAA
TAACCGGAAGA -> AACCGGAAGAG
GTGAAGACATT -> TGAAGACATTC
GCTTGTGGGGG -> CTTGTGGGGGT
CGGATGGGAGT -> GGATGGGAGTC
TCGAGCGATCT -> CGAGCGATCTT
TTTGAGTGAGA -> TTGAGTGAGAT
TACTATACGCG -> ACTATACGCGA
GATGTCGCACT -> ATGTCGCACTG
CACACTCGGGT -> ACACTCGGGTG
ATATACGACTG -> TATACGACTGA
TCTTGCTCGAT -> CTTGCTCGATT
TTTCAGCGCCC -> TTCAGCGCCCC
GCCTTGTGCCC -> CCTTGTGCCCT
TAAGTCAAATT -> AAGTCAAATTG
GGGGCGGATGC -> GGGCGGATGCT
GACTAAGGATT -> ACTAAGGATTT
TCAACAGGGTA -> CAACAGGGTAG
CTTGAACGCCA -> TTGAACGCCAC
CTTCATTTGGA -> TTCATTTGGAA
TATGGTGCTCA -> ATGGTGCTCAA
ACCAATGACTT -> CCAATGACTTC
CGATTGCCATC -> GATTGCCATCG
TGTCGCACTGA -> GTCGCACTGAC
GTGCCCTTCGA -> TGCCCTTCGAA
CACGTAGTAGG -> ACGTAGTAGGT
GAGGACATTAA -> AGGACATTAAT
AACTCGGGGCT -> ACTCGGGGCTT
ACTGATCCTGA -> CTGATCCTGAT
AATTACTATAA -> ATTACTATAAG
GATAGATATAC -> ATAGATATACG
ACCTATTTTAG -> CCTATTTTAGT
GCACGACGTTC -> CACGACGTTCT
GGGTGCCGTTG -> GGTGCCGTTGA
GCTGACATTGC -> CTGACATTGCT
CCCAATTATTC -> CCAATTATTCG
TCTGCCAACCC -> CTGCCAACCCA
TGTATCTGTAT -> GTATCTGTATG
CGGGATCGTTT -> GGGATCGTTTG
GAAAAAACTAT -> AAAAAACTATC
GTGCCGTTGAG -> TGCCGTTGAGA
AAGGGATAGAT -> AGGGATAGATC
TTGGACATTTA -> TGGACATTTAC
CGGAAGAGGCT -> GGAAGAGGCTA
AACCCTACGTA -> ACCCTACGTAT
TAAGTGTGGAC -> AAGTGTGGACA
GGCACGTTCTA -> GCACGTTCTAA
GCTCCCTTCAC -> CTCCCTTCACT
GAGGCTATCCT -> AGGCTATCCTT
CTAATATGGTA -> TAATATGGTAA
ACCAGTGTCGT -> CCAGTGTCGTA
TGCTGTTCCGC -> GCTGTTCCGCA
GTTGACGCTTG -> TTGACGCTTGT
AAAGAACCTCA -> AAGAACCTCAC
GAAGAATAAGG -> AAGAATAAGGG
GGTTGGGTTTC -> GTTGGGTTTCA
GTGCCAACATT -> TGCCAACATTT
ATACGTCCCTA -> TACGTCCCTAA
GGCTAGGCCTT -> GCTAGGCCTTG
CATAAAACTCG -> ATAAAACTCGG
GGTCTTGGATC -> GTCTTGGATCG
AAACGTCCTAA -> AACGTCCTAAT
ATGGTAACACT -> TGGTAACACTA
TACGCCGACTT -> ACGCCGACTTA
GGTAACCCCCG -> GTAACCCCCGC
AGTCATTTAAT -> GTCATTTAATT
ATGCTGCTAGT -> TGCTGCTAGTC
GGACGACTATC -> GACGACTATCC
TATGAAACGGG -> ATGAAACGGGG
AGTGTCGTAAG -> GTGTCGTAAGT
GGGCTGACATT -> GGCTGACATTG
CAAACCAATGA -> AAACCAATGAC
TAAAAGTATCA -> AAAAGTATCAA
GCGAGCGCGTC -> CGAGCGCGTCG
CAGTCATTTAA -> AGTCATTTAAT
AATAAGGGTTG -> ATAAGGGTTGG
GGCTGCTCTCG -> GCTGCTCTCGG
CTAACTGATCC -> TAACTGATCCT
TTGAGTGAGAT -> TGAGTGAGATC
TCATAGGAAAA -> CATAGGAAAAA
AACCCAAATTT -> ACCCAAATTTG
GGTGGCGCCTA -> GTGGCGCCTAA
TAATATGGTAA -> AATATGGTAAC
ACACCTATTTT -> CACCTATTTTA
GGGCGAGGAAC -> GGCGAGGAACT
TCTCGGTCTTG -> CTCGGTCTTGG
CCTCCCTCTAA -> CTCCCTCTAAT
CCAATCGTGTG -> CAATCGTGTGA
TAATCTTCCAA -> AATCTTCCAAC
TAACCCCCGCT -> AACCCCCGCTG
GGCTCACTATA -> GCTCACTATAG
AAATTGCAGCC -> AATTGCAGCCT
CATTTCAGCGC -> ATTTCAGCGCC
GTTAAAATTAG -> TTAAAATTAGG
GATCGAACTGA -> ATCGAACTGAG
GTTGCTGTTCC -> TTGCTGTTCCG
ACCTCCCTCTA -> CCTCCCTCTAA
TTGCTCCGACT -> TGCTCCGACTG
ACCCCCGCTGT -> CCCCCGCTGTA
AGCGCGTCGTG -> GCGCGTCGTGC
TTTTCGCCTGA -> TTTCGCCTGAT
ATGGCAGTTGC -> TGGCAGTTGCT
TTGCTCGATTT -> TGCTCGATTTA
CCTAACTGATC -> CTAACTGATCC
TTCTTGTTGAC -> TCTTGTTGACG
CCAATGACTTC -> CAATGACTTCG
AGTGAGATCGA -> GTGAGATCGAA
CTTGTGCCCTT -> TTGTGCCCTTC
CCGTAATCTTC -> CGTAATCTTCC
TTTTACTTCTG -> TTTACTTCTGC
GTATGAATAGG -> TATGAATAGGA
AACAGTCTTGC -> ACAGTCTTGCT
GCGCCCCGTTA -> CGCCCCGTTAA
TTCCTGTAGCG -> TCCTGTAGCGA
ACACACTCGGG -> CACACTCGGGT
ACACTAGATGG -> CACTAGATGGT
ATTCTTGAACG -> TTCTTGAACGC
TACGTATGAAT -> ACGTATGAATA
ATACCCGGGCA -> TACCCGGGCAA
GAAGACATTCT -> AAGACATTCTT
CGGGACAGGCA -> GGGACAGGCAA
TTAAAATTAGG -> TAAAATTAGGA
CGCTCGTTTTA -> GCTCGTTTTAG
CGCCTAACCGT -> GCCTAACCGTC
TGTATAGGGAC -> GTATAGGGACG
ATGACGCAGCT -> TGACGCAGCTT
GGAGAATCCAT -> GAGAATCCATG
ACGTTCTAGGT -> CGTTCTAGGTG
GGGACTTACCC -> GGACTTACCCT
TAAAGTATGAA -> AAAGTATGAAG
AAGTATGAAGG -> AGTATGAAGGC
AATTATTCGAC -> ATTATTCGACA
ACGCACCCTCT -> CGCACCCTCTT
ATGGATGATGA -> TGGATGATGAA
GACTACGACGG -> ACTACGACGGT
GGGATAGATAT -> GGATAGATATA
GATCACCATTT -> ATCACCATTTG
GTAGGTTCGCA -> TAGGTTCGCAG
GACGCTATCAT -> ACGCTATCATT
GTCTTGGATCG -> TCTTGGATCGG
ATGGGCCCCAA -> TGGGCCCCAAT
TTGCAGCCTAT -> TGCAGCCTATG
TTGACGCTTGT -> TGACGCTTGTG
GTGGACCGAAT -> TGGACCGAATT
TCAGGCTAGGC -> CAGGCTAGGCC
CAATTGCCAGT -> AATTGCCAGTA
CTGAGGACATT -> TGAGGACATTA
TCGCCGCTGAG -> CGCCGCTGAGG
ACTGACTTGAA -> CTGACTTGAAC
CGCACTGACTC -> GCACTGACTCG
CTGAGCAATGG -> TGAGCAATGGG
AACGGGGCTGA -> ACGGGGCTGAC
CCCTCTAATAT -> CCTCTAATATG
ACTTAGAGGGG -> CTTAGAGGGGG
GGCTTGGATAC -> GCTTGGATACC
AAAGCACGACG -> AAGCACGACGT
CTTCCTCGTGC -> TTCCTCGTGCC
GCTGTAGGTTC -> CTGTAGGTTCG
CTTACCCTTCA -> TTACCCTTCAT
ACGGGGCTGAC -> CGGGGCTGACA
CCATGTAGATA -> CATGTAGATAA
GCCCGCAGTGC -> CCCGCAGTGCT
CCTGCTCCAAG -> CTGCTCCAAGC
TGACATTGCTC -> GACATTGCTCG
CCGTCTCGCTT -> CGTCTCGCTTA
ACCATGTAGAT -> CCATGTAGATA
ATGATGAAAGC -> TGATGAAAGCC
ACTACGACGGT -> CTACGACGGTA
GATATACGACT -> ATATACGACTG
CGCACCCTCTT -> GCACCCTCTTA
CTACGACGGTA -> TACGACGGTAA
AATGGGCCCCA -> ATGGGCCCCAA
CAGTGAGGTGT -> AGTGAGGTGTT
CAATTGTCAGG -> AATTGTCAGGC
AGTACCGCTAC -> GTACCGCTACA
ACTATCCATTC -> CTATCCATTCG
CTATGGGGTGC -> TATGGGGTGCC
CTAGTCGAATT -> TAGTCGAATTT
AGGAACTGCCA -> GGAACTGCCAC
AAACTGGGTTA -> AACTGGGTTAA
AGTACCAGTGT -> GTACCAGTGTC
CTGTTCCGCAC -> TGTTCCGCACT
TACACCTATTT -> ACACCTATTTT
TTGGTATTATG -> TGGTATTATGT
ACGGGGGGCGG -> CGGGGGGCGGA
ATACGCGAACG -> TACGCGAACGC
TGGGTCACAGC -> GGGTCACAGCG
ATCGCGGGGAA -> TCGCGGGGAAT
GTAGTAGGTCC -> TAGTAGGTCCA
TGGCCGTTTCA -> GGCCGTTTCAC
TGGCGCCTAAC -> GGCGCCTAACC
TATACGACTGA -> ATACGACTGAC
GATCTCACCCG -> ATCTCACCCGT
CATGGGCATTT -> ATGGGCATTTC
CAAACTAATCA -> AAACTAATCAT
GTTAAAGAACC -> TTAAAGAACCT
CGGGGGGCGGA -> GGGGGGCGGAT
ACCGGAAGAGG -> CCGGAAGAGGC
CGGGGCTGACA -> GGGGCTGACAT
TAGGTTCGCAG -> AGGTTCGCAGG
GTGTATAGGGA -> TGTATAGGGAC
AAAAGTAACAG -> AAAGTAACAGT
CGCGGAAATTT -> GCGGAAATTTT
TGGGATCACCA -> GGGATCACCAT
GCTCCGACTGT -> CTCCGACTGTC
GAACGCCGGAC -> AACGCCGGACT
GAGTGGGTCAC -> AGTGGGTCACA
AATTATAATCG -> ATTATAATCGC
GACATTGCTCG -> ACATTGCTCGG
GGAACGGCAGA -> GAACGGCAGAC
CTCGTTTTAGT -> TCGTTTTAGTG
TTGAACGCCAC -> TGAACGCCACC
GAGATCGAACT -> AGATCGAACTG
TATCCCAGTCA -> ATCCCAGTCAT
TTTACTATACG -> TTACTATACGC
ACTAGCCTCAT -> CTAGCCTCATT
CCTGATGTCGC -> CTGATGTCGCA
CATTCTTGAAC -> ATTCTTGAACG
CCTGCAAATTA -> CTGCAAATTAT
CCAACCCTACG -> CAACCCTACGT
ATCATGGGCAT -> TCATGGGCATT
GCTATCCTTCG -> CTATCCTTCGC
GTGGTGATTGT -> TGGTGATTGTA
TAGGGACGACT -> AGGGACGACTA
GAAAGCACGAC -> AAAGCACGACG
GCTTGGTATCA -> CTTGGTATCAT
TGGAATGTCGC -> GGAATGTCGCG
AGTGCCTATGG -> GTGCCTATGGG
CGTTTCACCCC -> GTTTCACCCCC
TGGGGGTGGAC -> GGGGGTGGACC
GGGAGTCCCGG -> GGAGTCCCGGG
ATCATAGGAAA -> TCATAGGAAAA
ATTTAATTGGA -> TTTAATTGGAC
AGTAAGGGACT -> GTAAGGGACTT
TTGTCAGGCTC -> TGTCAGGCTCC
TTGAGAGGGTG -> TGAGAGGGTGC
GGGACGACTAT -> GGACGACTATC
TGGCGCTCGTT -> GGCGCTCGTTT
CTACGTATGAA -> TACGTATGAAT
