CCCGGAATCCCAGCTCATG -> CCGGAATCCCAGCTCATGT
GATACGCCAGAAACGTACT -> ATACGCCAGAAACGTACTT
AAGGCGTGGTGGGGTGTCA -> AGGCGTGGTGGGGTGTCAT
AAACACTCGGGGTCAACAC -> AACACTCGGGGTCAACACA
CTAATTGAGGAATGCTCCG -> TAATTGAGGAATGCTCCGG
GACAGGGCATCTTTGATTT -> ACAGGGCATCTTTGATTTT
TTATCGGTATTCAGTTTAG -> TATCGGTATTCAGTTTAGG
TCACGGTCTCTGAGGACCC -> CACGGTCTCTGAGGACCCG
AGCCACCCTTCCGAAAAAC -> GCCACCCTTCCGAAAAACC
CGTACTTTTTGTTCGCAGA -> GTACTTTTTGTTCGCAGAT
AATTGAGTGGCTCTCCTGG -> ATTGAGTGGCTCTCCTGGA
TATCGACACAGGATCGAGC -> ATCGACACAGGATCGAGCA
GTTGCCTCTCAGGGGGGTG -> TTGCCTCTCAGGGGGGTGT
TTCACAGTATCAAGATTTT -> TCACAGTATCAAGATTTTG
CATATCCAAGTCCCGTAAA -> ATATCCAAGTCCCGTAAAC
GTTTGCGGCTCGTATGTCA -> TTTGCGGCTCGTATGTCAC
TAGCTGCGGGATGCTTCTT -> AGCTGCGGGATGCTTCTTC
AAAGAACTTAAGTGCACCC -> AAGAACTTAAGTGCACCCT
TTGCCCTGAGTGTCGCTCC -> TGCCCTGAGTGTCGCTCCT
TCTCACGCCCAAGTACGGT -> CTCACGCCCAAGTACGGTT
ATTTACCGCACTATGCGTT -> TTTACCGCACTATGCGTTG
TAGCGCCAGCTCCCCGCCA -> AGCGCCAGCTCCCCGCCAA
CTTTTTGAGTATGCCCCTG -> TTTTTGAGTATGCCCCTGT
CGTTTACACTGTACAAGAC -> GTTTACACTGTACAAGACC
GCCTGAGATGCATCCTGGG -> CCTGAGATGCATCCTGGGG
CGGGTTGTTGCCCGGAATC -> GGGTTGTTGCCCGGAATCC
GCCAGGCGGCGTAGTCTCA -> CCAGGCGGCGTAGTCTCAG
AAGGTGTTCTACCTTAGTA -> AGGTGTTCTACCTTAGTAA
ATTATGATTCCCCCTTACG -> TTATGATTCCCCCTTACGG
CCATATCCTTAGTAACAAA -> CATATCCTTAGTAACAAAG
CGCCTAGGTATAAAGCATC -> GCCTAGGTATAAAGCATCG
TAAACTGACAGCATATTCT -> AAACTGACAGCATATTCTG
CCGTAGATACGCCAGAAAC -> CGTAGATACGCCAGAAACG
ATGTTGCGCAGCATACGCC -> TGTTGCGCAGCATACGCCG
TGCAGTAAATGGATGCTGG -> GCAGTAAATGGATGCTGGA
GACCTTCTTGAACGCATGT -> ACCTTCTTGAACGCATGTT
ATATCCAAGTCCCGTAAAC -> TATCCAAGTCCCGTAAACT
ATACTGGAGATAACATGTG -> TACTGGAGATAACATGTGG
GATGACGCGTTTTCCTGCT -> ATGACGCGTTTTCCTGCTG
CCCGCAGGACTACCTTTCA -> CCGCAGGACTACCTTTCAC
GCCCTGTGAGGCGTTTGTC -> CCCTGTGAGGCGTTTGTCC
GCAACCCCAGAAGAGTACA -> CAACCCCAGAAGAGTACAG
GTTCGCAGATTAGTACTGT -> TTCGCAGATTAGTACTGTC
ATGGAGATGGGCGACCCGA -> TGGAGATGGGCGACCCGAT
GAGCCACCCTTCCGAAAAA -> AGCCACCCTTCCGAAAAAC
AGATATCCTCAAGTGGTAA -> GATATCCTCAAGTGGTAAC
TCCTCAATTTACCGCACTA -> CCTCAATTTACCGCACTAT
CTGGTCGGATCATCGCGAT -> TGGTCGGATCATCGCGATG
CCAGACCTTCTTGAACGCA -> CAGACCTTCTTGAACGCAT
GGTAGGCGATCCCCAGACC -> GTAGGCGATCCCCAGACCT
TCTTTTTGAGTATGCCCCT -> CTTTTTGAGTATGCCCCTG
CTGGGGTGAGACGATATCC -> TGGGGTGAGACGATATCCC
TCGCAATAGATGGGTACCG -> CGCAATAGATGGGTACCGG
AACCCATCAATTTAGGATT -> ACCCATCAATTTAGGATTC
TACGCACTGACTATTATAC -> ACGCACTGACTATTATACG
ACAGGATCGAGCAGCCACA -> CAGGATCGAGCAGCCACAT
CGTCCGCATGCCACAGTAT -> GTCCGCATGCCACAGTATC
CTGCAACCCCAGAAGAGTA -> TGCAACCCCAGAAGAGTAC
CAGCAACGACAAGGCGTGG -> AGCAACGACAAGGCGTGGT
TCCTGGACCTCAGTTACTA -> CCTGGACCTCAGTTACTAC
GGACCCAAAGATCGCTTTT -> GACCCAAAGATCGCTTTTT
CTCTGCAGTGGTATATAGC -> TCTGCAGTGGTATATAGCG
GAGTATGATTGAGTAAACC -> AGTATGATTGAGTAAACCT
TTCCCAGTAACAATTTGAT -> TCCCAGTAACAATTTGATC
AGATGGCCCTAGGGTGCAA -> GATGGCCCTAGGGTGCAAC
GGGAACGGAACGGGACCCA -> GGAACGGAACGGGACCCAA
TATTCAGTTTAGGATGTTG -> ATTCAGTTTAGGATGTTGG
ATACGCCGGGGGGGTAGGA -> TACGCCGGGGGGGTAGGAG
ATCATCGCGATGCGCGTGG -> TCATCGCGATGCGCGTGGT
ATTAATAGGTAATCGTATC -> TTAATAGGTAATCGTATCC
TATATAGCGGTATGGGTCC -> ATATAGCGGTATGGGTCCG
TTGACTACATCCCGAAATT -> TGACTACATCCCGAAATTG
CTGCCCGTTCACCTCAACG -> TGCCCGTTCACCTCAACGC
TACGCCGGGGGGGTAGGAG -> ACGCCGGGGGGGTAGGAGA
AAGAACTTAAGTGCACCCT -> AGAACTTAAGTGCACCCTT
GCATGTTTGCCTCAGTTAA -> CATGTTTGCCTCAGTTAAC
GGGGGGTAGGAGATATCCT -> GGGGGTAGGAGATATCCTC
CGTTCACCTCAACGCAACC -> GTTCACCTCAACGCAACCT
TGACAGGGCATCTTTGATT -> GACAGGGCATCTTTGATTT
AGAACTTCCACGTATCTGA -> GAACTTCCACGTATCTGAT
TCGTTTACACTGTACAAGA -> CGTTTACACTGTACAAGAC
TGGGGTGAGACGATATCCC -> GGGGTGAGACGATATCCCT
TGCTGGACTGACAGCAACG -> GCTGGACTGACAGCAACGA
CAAGGCGTGGTGGGGTGTC -> AAGGCGTGGTGGGGTGTCA
AGTTTAGGATGTTGGTCTG -> GTTTAGGATGTTGGTCTGC
GGCACGCTTCGGATGCGTC -> GCACGCTTCGGATGCGTCA
TGGGTTGACTACATCCCGA -> GGGTTGACTACATCCCGAA
ACCCGTAGATACGCCAGAA -> CCCGTAGATACGCCAGAAA
ACGACTGACGTCCATTTCT -> CGACTGACGTCCATTTCTT
CATGTTTGCCTCAGTTAAC -> ATGTTTGCCTCAGTTAACG
TAAGTGCACCCTTTGAGCG -> AAGTGCACCCTTTGAGCGG
TCTCAGGGTCCGACGGGTC -> CTCAGGGTCCGACGGGTCT
TTCTATCGAGTATGATTGA -> TCTATCGAGTATGATTGAG
GGGTCCGGGTAGGCCAGGC -> GGTCCGGGTAGGCCAGGCG
TGTACAAGACCTCTCACGA -> GTACAAGACCTCTCACGAT
TATGCCCCTGTAATGGGAA -> ATGCCCCTGTAATGGGAAC
GCGAACCCGAAAGATGGCC -> CGAACCCGAAAGATGGCCC
CGGGGTCAACACAAAGCAT -> GGGGTCAACACAAAGCATT
ACGCAACCTAATTGAGGAA -> CGCAACCTAATTGAGGAAT
AGCTTTTCCCAGTAACAAT -> GCTTTTCCCAGTAACAATT
ATGGGTACCGGCGTTCGTT -> TGGGTACCGGCGTTCGTTT
AATAACCATGGCACCGGAC -> ATAACCATGGCACCGGACA
TGTACTCATATCCAAGTCC -> GTACTCATATCCAAGTCCC
AGTCTCAGGGTCCGACGGG -> GTCTCAGGGTCCGACGGGT
TTAAACACTCGGGGTCAAC -> TAAACACTCGGGGTCAACA
GGGTTACGCTATGTGCCCT -> GGTTACGCTATGTGCCCTG
GTTTGTCCGCCCGACTACA -> TTTGTCCGCCCGACTACAT
GAGGTAGGCGATCCCCAGA -> AGGTAGGCGATCCCCAGAC
GCGGCGTAGTCTCAGGGTC -> CGGCGTAGTCTCAGGGTCC
TCCGACGGGTCTATAAATG -> CCGACGGGTCTATAAATGA
CTTTTTGTACGTCCTTTCT -> TTTTTGTACGTCCTTTCTA
CGTTGTCTTATTGTATTAG -> GTTGTCTTATTGTATTAGA
TAATGGGAACGGAACGGGA -> AATGGGAACGGAACGGGAC
ATGCTGGACTGACAGCAAC -> TGCTGGACTGACAGCAACG
TGTGCAGCCACTGGAGATG -> GTGCAGCCACTGGAGATGG
AACTGACAGCATATTCTGG -> ACTGACAGCATATTCTGGG
CTACCTTAGTAACAAAGAA -> TACCTTAGTAACAAAGAAC
CCCTGTAATGGGAACGGAA -> CCTGTAATGGGAACGGAAC
CACTTTCAAATTTAGCTGC -> ACTTTCAAATTTAGCTGCG
GGTCAACAGGTCCCATGAG -> GTCAACAGGTCCCATGAGA
GACGCGTTTTCCTGCTGGT -> ACGCGTTTTCCTGCTGGTA
ACGGGTCTATAAATGACAG -> CGGGTCTATAAATGACAGG
GCCTTAGTAACAAAGAACT -> CCTTAGTAACAAAGAACTT
GTGGGTTGACTACATCCCG -> TGGGTTGACTACATCCCGA
AGTAACAAAGAACTTGGCG -> GTAACAAAGAACTTGGCGG
TTACTACCATCGCCTAGGT -> TACTACCATCGCCTAGGTA
CAGCCACTGGAGATGGGGT -> AGCCACTGGAGATGGGGTT
TCAGGGTCCGACGGGTCTA -> CAGGGTCCGACGGGTCTAT
TGGGGGAATCCTGACGACT -> GGGGGAATCCTGACGACTG
GATCCCCAGACCTTCTTGA -> ATCCCCAGACCTTCTTGAA
ACGTCCTTTCTATCGAGTA -> CGTCCTTTCTATCGAGTAT
GCAGATTAGTACTGTCAGC -> CAGATTAGTACTGTCAGCG
GTCACTATATAAGACGTTC -> TCACTATATAAGACGTTCG
CTTAGCGCCAGCTCCCCGC -> TTAGCGCCAGCTCCCCGCC
GTAGATGACGCAATGGAGA -> TAGATGACGCAATGGAGAT
CTGACAGCAACGACAAGGC -> TGACAGCAACGACAAGGCG
CCAAGTACGGTTTAAAAGT -> CAAGTACGGTTTAAAAGTC
CTGACGACTGACGTCCATT -> TGACGACTGACGTCCATTT
CAAGACCTCTCACGATGAC -> AAGACCTCTCACGATGACG
GGTGTCATATGGGGGAATC -> GTGTCATATGGGGGAATCC
GGCATATGTTTGCGGCTCG -> GCATATGTTTGCGGCTCGT
GGCGGCAGGTAGTAGGGCT -> GCGGCAGGTAGTAGGGCTG
TCCCCAGACCTTCTTGAAC -> CCCCAGACCTTCTTGAACG
CCCATGAGAACGTTTGTCC -> CCATGAGAACGTTTGTCCC
TGAGTGTCGCTCCTTTTTG -> GAGTGTCGCTCCTTTTTGT
AGTAAACCTTAGCGCCAGC -> GTAAACCTTAGCGCCAGCT
TATGATAACGAAGTGTAAG -> ATGATAACGAAGTGTAAGG
ATACGCCAGAAACGTACTT -> TACGCCAGAAACGTACTTT
CCATTTCTTAGCTTTCATA -> CATTTCTTAGCTTTCATAC
GGTATGTGCTTACGAAGGT -> GTATGTGCTTACGAAGGTT
GCAGCCACTGGAGATGGGG -> CAGCCACTGGAGATGGGGT
ATATCCTTAGTAACAAAGA -> TATCCTTAGTAACAAAGAA
CCCTTCCGAAAAACCCATC -> CCTTCCGAAAAACCCATCA
GGGTCTATAAATGACAGGG -> GGTCTATAAATGACAGGGC
CCTCAAGTGGTAACAAATT -> CTCAAGTGGTAACAAATTA
CTTTGCGGGTTGTTGCCCG -> TTTGCGGGTTGTTGCCCGG
CAAGTCACGGGACTGGTCG -> AAGTCACGGGACTGGTCGG
ACCCGATCTGTGTGTGAAT -> CCCGATCTGTGTGTGAATG
CATGCCACAGTATCGAGAT -> ATGCCACAGTATCGAGATC
CCTAATAGGTCTCACGCCC -> CTAATAGGTCTCACGCCCA
GCTCGTATGTCACTATATA -> CTCGTATGTCACTATATAA
GGCCCTAGGGTGCAACGCA -> GCCCTAGGGTGCAACGCAA
CGCGTGGTACTCCCGTTGT -> GCGTGGTACTCCCGTTGTC
AATCGTATCCGGGCACCTT -> ATCGTATCCGGGCACCTTC
GCACGCTTCGGATGCGTCA -> CACGCTTCGGATGCGTCAC
AGCGGTTAGTGCATACTGG -> GCGGTTAGTGCATACTGGA
ATGACGCAATGGAGATGGG -> TGACGCAATGGAGATGGGC
ACCTTGCAGTAAATGGATG -> CCTTGCAGTAAATGGATGC
CTCGTATGTCACTATATAA -> TCGTATGTCACTATATAAG
TTTCTATCGAGTATGATTG -> TTCTATCGAGTATGATTGA
GGGTAGGAGATATCCTCAA -> GGTAGGAGATATCCTCAAG
ATGAGTGCATACGCACTGA -> TGAGTGCATACGCACTGAC
TTCGGATGCGTCACGGTCT -> TCGGATGCGTCACGGTCTC
TATCTGATGAGTGCATACG -> ATCTGATGAGTGCATACGC
GCAGGTAGTAGGGCTGAAG -> CAGGTAGTAGGGCTGAAGT
TGCCCTGTGAGGCGTTTGT -> GCCCTGTGAGGCGTTTGTC
GCAGTAAATGGATGCTGGA -> CAGTAAATGGATGCTGGAC
AACTTGGCGGCAGGTAGTA -> ACTTGGCGGCAGGTAGTAG
TTAGAGTTAGAGAATGTTG -> TAGAGTTAGAGAATGTTGC
TGCCCCTGTAATGGGAACG -> GCCCCTGTAATGGGAACGG
CTCCCGTTGTCTTATTGTA -> TCCCGTTGTCTTATTGTAT
AGGGGCCCATATCCTTAGT -> GGGGCCCATATCCTTAGTA
GAGATATCCTCAAGTGGTA -> AGATATCCTCAAGTGGTAA
GACGTGGATCCTTCCTTAG -> ACGTGGATCCTTCCTTAGT
ATCGAGATCATAATCTGTG -> TCGAGATCATAATCTGTGT
GTATCCGGGCACCTTCTTT -> TATCCGGGCACCTTCTTTT
CTATGATAACGAAGTGTAA -> TATGATAACGAAGTGTAAG
TTGAGTAAACCTTAGCGCC -> TGAGTAAACCTTAGCGCCA
ACAGTATCGAGATCATAAT -> CAGTATCGAGATCATAATC
ACTACATCCCGAAATTGAG -> CTACATCCCGAAATTGAGT
TAAGACGTTCGCAATAGAT -> AAGACGTTCGCAATAGATG
CACTCGGGGTCAACACAAA -> ACTCGGGGTCAACACAAAG
AGGATCGAGCAGCCACATC -> GGATCGAGCAGCCACATCC
TACACTGTACAAGACCTCT -> ACACTGTACAAGACCTCTC
GGTGAGACGATATCCCTTG -> GTGAGACGATATCCCTTGC
CCTGGACCTCAGTTACTAC -> CTGGACCTCAGTTACTACC
CCTCCGAGGGGCCCATATC -> CTCCGAGGGGCCCATATCC
CTCAGGGGGGTGTTTTGAT -> TCAGGGGGGTGTTTTGATC
TATTCCTCAATTTACCGCA -> ATTCCTCAATTTACCGCAC
GATCGAGCAGCCACATCCT -> ATCGAGCAGCCACATCCTT
TCCTTTCTATCGAGTATGA -> CCTTTCTATCGAGTATGAT
CTCAACGCAACCTAATTGA -> TCAACGCAACCTAATTGAG
CGCTTCGGATGCGTCACGG -> GCTTCGGATGCGTCACGGT
ATCCCCAGACCTTCTTGAA -> TCCCCAGACCTTCTTGAAC
GCGTGGTGGGGTGTCATAT -> CGTGGTGGGGTGTCATATG
TCCGCGTCCACTGCACCGT -> CCGCGTCCACTGCACCGTC
TTGCAGTAAATGGATGCTG -> TGCAGTAAATGGATGCTGG
TGTATTAGATTCCGAGTAG -> GTATTAGATTCCGAGTAGA
TTACACTGTACAAGACCTC -> TACACTGTACAAGACCTCT
TCCATATGCAATGTTGTAT -> CCATATGCAATGTTGTATC
CAAAGCATTGGGGTGTCAG -> AAAGCATTGGGGTGTCAGC
ACGGGACCCAAAGATCGCT -> CGGGACCCAAAGATCGCTT
TCCCCGCCAAAATTCACAG -> CCCCGCCAAAATTCACAGT
CAGCTCATGTGCAAATATT -> AGCTCATGTGCAAATATTG
TACGCCAGAAACGTACTTT -> ACGCCAGAAACGTACTTTT
GCGTGGTACTCCCGTTGTC -> CGTGGTACTCCCGTTGTCT
AACCCCAGAAGAGTACAGG -> ACCCCAGAAGAGTACAGGC
GTATCTGATGAGTGCATAC -> TATCTGATGAGTGCATACG
AGGCCTATTAGAGTTAGAG -> GGCCTATTAGAGTTAGAGA
GGACGGCCTGAGATGCATC -> GACGGCCTGAGATGCATCC
TGATTCCCCCTTACGGTAT -> GATTCCCCCTTACGGTATG
CCGCCAAAATTCACAGTAT -> CGCCAAAATTCACAGTATC
AGTATGCCCCTGTAATGGG -> GTATGCCCCTGTAATGGGA
GGGAATCCTGACGACTGAC -> GGAATCCTGACGACTGACG
TCCTGCTGGTAGATGACGC -> CCTGCTGGTAGATGACGCA
CACTGTACAAGACCTCTCA -> ACTGTACAAGACCTCTCAC
TCTGAGGACCCGTAGATAC -> CTGAGGACCCGTAGATACG
CAGAAACGTACTTTTTGTT -> AGAAACGTACTTTTTGTTC
ATCTGATGAGTGCATACGC -> TCTGATGAGTGCATACGCA
ACGCATGTTTGCCTCAGTT -> CGCATGTTTGCCTCAGTTA
CGCCGGGGGGGTAGGAGAT -> GCCGGGGGGGTAGGAGATA
ATGACAGGGCATCTTTGAT -> TGACAGGGCATCTTTGATT
CAGAAGAGTACAGGCCTAT -> AGAAGAGTACAGGCCTATT
GAATCCCAGCTCATGTGCA -> AATCCCAGCTCATGTGCAA
TCAAATTTAGCTGCGGGAT -> CAAATTTAGCTGCGGGATG
GTCCGACGGGTCTATAAAT -> TCCGACGGGTCTATAAATG
AATAGGTAATCGTATCCGG -> ATAGGTAATCGTATCCGGG
CTTTCTATCGAGTATGATT -> TTTCTATCGAGTATGATTG
ACGCACTGACTATTATACG -> CGCACTGACTATTATACGT
GGGGGAATCCTGACGACTG -> GGGGAATCCTGACGACTGA
TTAACGAGGTGCCTTGGAT -> TAACGAGGTGCCTTGGATG
ATATAAGACGTTCGCAATA -> TATAAGACGTTCGCAATAG
AAGACGTTCGCAATAGATG -> AGACGTTCGCAATAGATGG
GAAGTTTATTAATTGCCCT -> AAGTTTATTAATTGCCCTG
CCTGCATCCCTCACAGAAT -> CTGCATCCCTCACAGAATA
CGTTTGTCCAAGCTTTTCC -> GTTTGTCCAAGCTTTTCCC
CATACGCCGGGGGGGTAGG -> ATACGCCGGGGGGGTAGGA
AAATATTGTGGGTTGACTA -> AATATTGTGGGTTGACTAC
TTTATCGGTATTCAGTTTA -> TTATCGGTATTCAGTTTAG
GTACGGTTTAAAAGTCAGG -> TACGGTTTAAAAGTCAGGT
ATTTAGCTGCGGGATGCTT -> TTTAGCTGCGGGATGCTTC
CATACTGGAGATAACATGT -> ATACTGGAGATAACATGTG
GAGCAGCCACATCCTTTAG -> AGCAGCCACATCCTTTAGC
ATTTTGGTCAACAGGTCCC -> TTTTGGTCAACAGGTCCCA
AGTCAGGTAACCTTTGTGC -> GTCAGGTAACCTTTGTGCA
TAAACCTTAGCGCCAGCTC -> AAACCTTAGCGCCAGCTCC
TCCGAAAAACCCATCAATT -> CCGAAAAACCCATCAATTT
ACGTCCATTTCTTAGCTTT -> CGTCCATTTCTTAGCTTTC
CTGTACAAGACCTCTCACG -> TGTACAAGACCTCTCACGA
CTTTGATCTTGACCTCCGA -> TTTGATCTTGACCTCCGAC
GAACTTCCACGTATCTGAT -> AACTTCCACGTATCTGATG
TCCTACCAGTAACTCTGCA -> CCTACCAGTAACTCTGCAG
TTCACGCTGTGCGGGAACC -> TCACGCTGTGCGGGAACCT
TTGTATCGACACAGGATCG -> TGTATCGACACAGGATCGA
TTAGTAACAAAGAACTTAA -> TAGTAACAAAGAACTTAAG
GACCTCCGACGTGGATCCT -> ACCTCCGACGTGGATCCTT
GAAGGTTGATAGTTTGATC -> AAGGTTGATAGTTTGATCT
ACGCCGGGGGGGTAGGAGA -> CGCCGGGGGGGTAGGAGAT
GGGCGACCCGATCTGTGTG -> GGCGACCCGATCTGTGTGT
CGGAACGGGACCCAAAGAT -> GGAACGGGACCCAAAGATC
GTCGATTAATAGGTAATCG -> TCGATTAATAGGTAATCGT
TTCTTAGCTTTCATACGGT -> TCTTAGCTTTCATACGGTG
CATGTGGTATGATGAGCCA -> ATGTGGTATGATGAGCCAC
CAAGTGGTAACAAATTATG -> AAGTGGTAACAAATTATGA
AACAGGTCCCATGAGAACG -> ACAGGTCCCATGAGAACGT
CTACATCCCGAAATTGAGT -> TACATCCCGAAATTGAGTG
GGTATAAAGCATCGGGCTA -> GTATAAAGCATCGGGCTAG
GTCTCAGGGTCCGACGGGT -> TCTCAGGGTCCGACGGGTC
TCAGGGTGGAGCCTTAGTA -> CAGGGTGGAGCCTTAGTAA
CCAAGCTTTTCCCAGTAAC -> CAAGCTTTTCCCAGTAACA
TAAACTAAACTGACAGCAT -> AAACTAAACTGACAGCATA
TTGCGTCCGCATGCCACAG -> TGCGTCCGCATGCCACAGT
TGGATGTTGCCTCTCAGGG -> GGATGTTGCCTCTCAGGGG
ACGATGACGCGTTTTCCTG -> CGATGACGCGTTTTCCTGC
ATCGGTATTCAGTTTAGGA -> TCGGTATTCAGTTTAGGAT
GGGACCCAAAGATCGCTTT -> GGACCCAAAGATCGCTTTT
AGTGGTAACAAATTATGAT -> GTGGTAACAAATTATGATT
TCAGTTACTACCATCGCCT -> CAGTTACTACCATCGCCTA
CGGTATGGGTCCGGGTAGG -> GGTATGGGTCCGGGTAGGC
CCGCAGGACTACCTTTCAC -> CGCAGGACTACCTTTCACG
GCGGCTCGTATGTCACTAT -> CGGCTCGTATGTCACTATA
AAACCTTAGCGCCAGCTCC -> AACCTTAGCGCCAGCTCCC
TAAAAGTCAGGTAACCTTT -> AAAAGTCAGGTAACCTTTG
AAACTGACAGCATATTCTG -> AACTGACAGCATATTCTGG
CATCCTGGGGTGAGACGAT -> ATCCTGGGGTGAGACGATA
TATAGCGGTATGGGTCCGG -> ATAGCGGTATGGGTCCGGG
TGATGAGCCACCCTTCCGA -> GATGAGCCACCCTTCCGAA
GGTCTGCAACCCCAGAAGA -> GTCTGCAACCCCAGAAGAG
AATTCACAGTATCAAGATT -> ATTCACAGTATCAAGATTT
GTGCATACTGGAGATAACA -> TGCATACTGGAGATAACAT
CGCAACCTAATTGAGGAAT -> GCAACCTAATTGAGGAATG
GTGAGACGATATCCCTTGC -> TGAGACGATATCCCTTGCT
CACGCTTCGGATGCGTCAC -> ACGCTTCGGATGCGTCACG
ACCTTTGTGCAGCCACTGG -> CCTTTGTGCAGCCACTGGA
AACACTTTCAAATTTAGCT -> ACACTTTCAAATTTAGCTG
TTGTTGCCCGGAATCCCAG -> TGTTGCCCGGAATCCCAGC
AAGTCACGGGACTGGTCGG -> AGTCACGGGACTGGTCGGA
GGCGTTCGTTTACACTGTA -> GCGTTCGTTTACACTGTAC
TAGTACTGTCAGCGCTTTG -> AGTACTGTCAGCGCTTTGC
CCTCAATTTACCGCACTAT -> CTCAATTTACCGCACTATG
TAAAACATCCGATATTCCT -> AAAACATCCGATATTCCTC
ACCCATCAATTTAGGATTC -> CCCATCAATTTAGGATTCC
TGAGGAATGCTCCGGGACT -> GAGGAATGCTCCGGGACTA
CTTTCACGCTGTGCGGGAA -> TTTCACGCTGTGCGGGAAC
CGACACAGGATCGAGCAGC -> GACACAGGATCGAGCAGCC
GCCCTGCATCCCTCACAGA -> CCCTGCATCCCTCACAGAA
GGTGGGGTGTCATATGGGG -> GTGGGGTGTCATATGGGGG
GTGGTATATAGCGGTATGG -> TGGTATATAGCGGTATGGG
AAGGCAAGTCCGCGTCCAC -> AGGCAAGTCCGCGTCCACT
GATCTTGACCTCCGATCAG -> ATCTTGACCTCCGATCAGG
AACGCAACCTAATTGAGGA -> ACGCAACCTAATTGAGGAA
CGAGTATGATTGAGTAAAC -> GAGTATGATTGAGTAAACC
CCGAGGGGCCCATATCCTT -> CGAGGGGCCCATATCCTTA
ACAATTTGATCTTGACCTC -> CAATTTGATCTTGACCTCC
AATTTGATCTTGACCTCCG -> ATTTGATCTTGACCTCCGA
GTCCGCGTCCACTGCACCG -> TCCGCGTCCACTGCACCGT
ACGCAATGGAGATGGGCGA -> CGCAATGGAGATGGGCGAC
ACCATCGCCTAGGTATAAA -> CCATCGCCTAGGTATAAAG
GTATTAGATTCCGAGTAGA -> TATTAGATTCCGAGTAGAT
CGAGGGGCCCATATCCTTA -> GAGGGGCCCATATCCTTAG
TCCGAAAGGTGTTCTACCT -> CCGAAAGGTGTTCTACCTT
GGGTAGGCCAGGCGGCGTA -> GGTAGGCCAGGCGGCGTAG
TTAGCGCCAGCTCCCCGCC -> TAGCGCCAGCTCCCCGCCA
CCTTTCTATCGAGTATGAT -> CTTTCTATCGAGTATGATT
TCCTTTTTGTACGTCCTTT -> CCTTTTTGTACGTCCTTTC
TCCACGTATCTGATGAGTG -> CCACGTATCTGATGAGTGC
ACAAAGAACTTGGCGGCAG -> CAAAGAACTTGGCGGCAGG
CTCCTTTTTGTACGTCCTT -> TCCTTTTTGTACGTCCTTT
GGATGTTGGTCTGCAACCC -> GATGTTGGTCTGCAACCCC
ACGGAAACCTTGCAGTAAA -> CGGAAACCTTGCAGTAAAT
TCATGTGCAAATATTGTGG -> CATGTGCAAATATTGTGGG
GTGCACCCTTTGAGCGGTT -> TGCACCCTTTGAGCGGTTA
ATGTGCAAATATTGTGGGT -> TGTGCAAATATTGTGGGTT
TAGTAACAAAGAACTTCGT -> AGTAACAAAGAACTTCGTT
GGGTGCAACGCAATCGCCT -> GGTGCAACGCAATCGCCTC
ATGTTGGTCTGCAACCCCA -> TGTTGGTCTGCAACCCCAG
GCATTGGGGTGTCAGCGAA -> CATTGGGGTGTCAGCGAAC
TTTTTGTTCGCAGATTAGT -> TTTTGTTCGCAGATTAGTA
CTGATGAGTGCATACGCAC -> TGATGAGTGCATACGCACT
TTGATCTTGACCTCCGAGG -> TGATCTTGACCTCCGAGGG
CAAAGAACTTGGCGGCAGG -> AAAGAACTTGGCGGCAGGT
ACGAGGTGCCTTGGATGTT -> CGAGGTGCCTTGGATGTTG
GTAATGGGAACGGAACGGG -> TAATGGGAACGGAACGGGA
ATGGATGCTGGACTGACAG -> TGGATGCTGGACTGACAGC
AGGCCCTGCATCCCTCACA -> GGCCCTGCATCCCTCACAG
CCGGACGGCCTGAGATGCA -> CGGACGGCCTGAGATGCAT
ACGGTGCACGAGGTAGGCG -> CGGTGCACGAGGTAGGCGA
CTCAGTTACTACCATCGCC -> TCAGTTACTACCATCGCCT
TAACAAATTATGATTCCCC -> AACAAATTATGATTCCCCC
GATTCCGAGTAGATACGGA -> ATTCCGAGTAGATACGGAA
AATGTCAATAACCATGGCA -> ATGTCAATAACCATGGCAC
TTTAGGATGTTGGTCTGCA -> TTAGGATGTTGGTCTGCAA
GTTGTCTTATTGTATTAGA -> TTGTCTTATTGTATTAGAT
CGAGATCATAATCTGTGTA -> GAGATCATAATCTGTGTAC
CATGAGAACGTTTGTCCCG -> ATGAGAACGTTTGTCCCGC
GGCTCGTATGTCACTATAT -> GCTCGTATGTCACTATATA
CGATTAATAGGTAATCGTA -> GATTAATAGGTAATCGTAT
GCCACCCTTCCGAAAAACC -> CCACCCTTCCGAAAAACCC
TGACCTCCGACGTGGATCC -> GACCTCCGACGTGGATCCT
CTTACGAAGGTTGATAGTT -> TTACGAAGGTTGATAGTTT
CCTAGGGTGCAACGCAATC -> CTAGGGTGCAACGCAATCG
AATAGGTCTCACGCCCAAG -> ATAGGTCTCACGCCCAAGT
CTCAGTTAACGAGGTGCCT -> TCAGTTAACGAGGTGCCTT
GACAAGGCGTGGTGGGGTG -> ACAAGGCGTGGTGGGGTGT
GAATGTTGCGCAGCATACG -> AATGTTGCGCAGCATACGC
TTCATACGGTGCACGAGGT -> TCATACGGTGCACGAGGTA
ACTGACAGCAACGACAAGG -> CTGACAGCAACGACAAGGC
AGATGCATCCTGGGGTGAG -> GATGCATCCTGGGGTGAGA
CTAGAACCTGCCCGTTCAC -> TAGAACCTGCCCGTTCACC
ATTAGAGTTAGAGAATGTT -> TTAGAGTTAGAGAATGTTG
GGAGCCTTAGTAACAAAGA -> GAGCCTTAGTAACAAAGAA
CAGCGCTTTGCGGGTTGTT -> AGCGCTTTGCGGGTTGTTG
TTAATAGGTAATCGTATCC -> TAATAGGTAATCGTATCCG
AGGTAATCGTATCCGGGCA -> GGTAATCGTATCCGGGCAC
TCCAACACTTTCAAATTTA -> CCAACACTTTCAAATTTAG
GGACTGACAGCAACGACAA -> GACTGACAGCAACGACAAG
ATTCCCCCTTACGGTATGT -> TTCCCCCTTACGGTATGTG
CCAAAATTCACAGTATCAA -> CAAAATTCACAGTATCAAG
CCGATCTGTGTGTGAATGT -> CGATCTGTGTGTGAATGTC
GGAACGGGACCCAAAGATC -> GAACGGGACCCAAAGATCG
TGCCACAGTATCGAGATCA -> GCCACAGTATCGAGATCAT
TCCGAGGGGCCCATATCCT -> CCGAGGGGCCCATATCCTT
TCGGGGTCAACACAAAGCA -> CGGGGTCAACACAAAGCAT
ATAGCGGTATGGGTCCGGG -> TAGCGGTATGGGTCCGGGT
CTGGGCACGCTTCGGATGC -> TGGGCACGCTTCGGATGCG
TGCTTCTTCAGCCCCGCAG -> GCTTCTTCAGCCCCGCAGG
GTAACAAAGAACTTAAGTG -> TAACAAAGAACTTAAGTGC
TGGAGCCTTAGTAACAAAG -> GGAGCCTTAGTAACAAAGA
CAGTAAATGGATGCTGGAC -> AGTAAATGGATGCTGGACT
GTTTGATCTTGACCTCCGA -> TTTGATCTTGACCTCCGAG
GGTTGATAGTTTGATCTTG -> GTTGATAGTTTGATCTTGA
GATAGTTTGATCTTGACCT -> ATAGTTTGATCTTGACCTC
TCCGACGTGGATCCTTCCT -> CCGACGTGGATCCTTCCTT
ACTTTTTGTTCGCAGATTA -> CTTTTTGTTCGCAGATTAG
GCAATAGATGGGTACCGGC -> CAATAGATGGGTACCGGCG
CAAATGGCATATGTTTGCG -> AAATGGCATATGTTTGCGG
CTCAGGGTCCGACGGGTCT -> TCAGGGTCCGACGGGTCTA
TGGGTCCGGGTAGGCCAGG -> GGGTCCGGGTAGGCCAGGC
GAATAAAACATCCGATATT -> AATAAAACATCCGATATTC
GTTGACTACATCCCGAAAT -> TTGACTACATCCCGAAATT
AGGTGCCTTGGATGTTGCC -> GGTGCCTTGGATGTTGCCT
TCCGCCCGACTACATCCCT -> CCGCCCGACTACATCCCTG
CCCAAGTACGGTTTAAAAG -> CCAAGTACGGTTTAAAAGT
ATAGGTAATCGTATCCGGG -> TAGGTAATCGTATCCGGGC
GGAAGTCTAGAACCTGCCC -> GAAGTCTAGAACCTGCCCG
TCCTCAAGTGGTAACAAAT -> CCTCAAGTGGTAACAAATT
GGCTGAAGTTTATTAATTG -> GCTGAAGTTTATTAATTGC
CGCAGATTAGTACTGTCAG -> GCAGATTAGTACTGTCAGC
CCTGACGACTGACGTCCAT -> CTGACGACTGACGTCCATT
CAGTTAACGAGGTGCCTTG -> AGTTAACGAGGTGCCTTGG
GAGGACCCGTAGATACGCC -> AGGACCCGTAGATACGCCA
GGACTACCTTTCACGCTGT -> GACTACCTTTCACGCTGTG
CGCTGTGCGGGAACCTATG -> GCTGTGCGGGAACCTATGA
AGAACTTAAGTGCACCCTT -> GAACTTAAGTGCACCCTTT
AAATTATGATTCCCCCTTA -> AATTATGATTCCCCCTTAC
TTTTCGCCGGACGGCCTGA -> TTTCGCCGGACGGCCTGAG
GGGATGCTTCTTCAGCCCC -> GGATGCTTCTTCAGCCCCG
ACAAAGCATTGGGGTGTCA -> CAAAGCATTGGGGTGTCAG
CTTTTCGCCGGACGGCCTG -> TTTTCGCCGGACGGCCTGA
CATCCCGAAATTGAGTGGC -> ATCCCGAAATTGAGTGGCT
ATCTTTGATTTTGCGTCCG -> TCTTTGATTTTGCGTCCGC
CAAAGAACTTCGTTTGTCC -> AAAGAACTTCGTTTGTCCA
GTAACAAAGAACTTGGCGG -> TAACAAAGAACTTGGCGGC
ACCTCAGTTACTACCATCG -> CCTCAGTTACTACCATCGC
TCGGATGCGTCACGGTCTC -> CGGATGCGTCACGGTCTCT
CGGACATCTTCTTTTTGAG -> GGACATCTTCTTTTTGAGT
CAGCCCCGCAGGACTACCT -> AGCCCCGCAGGACTACCTT
GCGAACAAGTCACGGGACT -> CGAACAAGTCACGGGACTG
TTTGAGCGGTTAGTGCATA -> TTGAGCGGTTAGTGCATAC
ACGCTATGTGCCCTGTGAG -> CGCTATGTGCCCTGTGAGG
ATACGTTTATCGGTATTCA -> TACGTTTATCGGTATTCAG
ATCGCCTCCAACACTTTCA -> TCGCCTCCAACACTTTCAA
TATTGTGGGTTGACTACAT -> ATTGTGGGTTGACTACATC
CACTGGAGATGGGGTTACG -> ACTGGAGATGGGGTTACGC
CAGGGTGGAGCCTTAGTAA -> AGGGTGGAGCCTTAGTAAC
GTGTACTCATATCCAAGTC -> TGTACTCATATCCAAGTCC
TTATTAATTGCCCTGAGTG -> TATTAATTGCCCTGAGTGT
CCTGGGGTGAGACGATATC -> CTGGGGTGAGACGATATCC
CGCGATGCGCGTGGTACTC -> GCGATGCGCGTGGTACTCC
TTACGCTATGTGCCCTGTG -> TACGCTATGTGCCCTGTGA
GTGAATGTCAATAACCATG -> TGAATGTCAATAACCATGG
ACACTGTACAAGACCTCTC -> CACTGTACAAGACCTCTCA
CAAAGAACTTAAGTGCACC -> AAAGAACTTAAGTGCACCC
ATCCCGAAATTGAGTGGCT -> TCCCGAAATTGAGTGGCTC
ACCTAATTGAGGAATGCTC -> CCTAATTGAGGAATGCTCC
CAATGTTGTATCGACACAG -> AATGTTGTATCGACACAGG
CCGATATTCCTCAATTTAC -> CGATATTCCTCAATTTACC
GGTGTTTTGATCTTGACCT -> GTGTTTTGATCTTGACCTC
TATTGTATTAGATTCCGAG -> ATTGTATTAGATTCCGAGT
AGACCTCTCACGATGACGC -> GACCTCTCACGATGACGCG
CTAAGGCCCTGCATCCCTC -> TAAGGCCCTGCATCCCTCA
AGCATTGGGGTGTCAGCGA -> GCATTGGGGTGTCAGCGAA
GGAATGCTCCGGGACTAAG -> GAATGCTCCGGGACTAAGG
AACCTGCCCGTTCACCTCA -> ACCTGCCCGTTCACCTCAA
TACAGGCCTATTAGAGTTA -> ACAGGCCTATTAGAGTTAG
CGCCAGAAACGTACTTTTT -> GCCAGAAACGTACTTTTTG
CCACAGTATCGAGATCATA -> CACAGTATCGAGATCATAA
CCTTCTTTTCGCCGGACGG -> CTTCTTTTCGCCGGACGGC
CAATTTAAACACTCGGGGT -> AATTTAAACACTCGGGGTC
GATGCTGGACTGACAGCAA -> ATGCTGGACTGACAGCAAC
AACCCGAAAGATGGCCCTA -> ACCCGAAAGATGGCCCTAG
GGATGCGTCACGGTCTCTG -> GATGCGTCACGGTCTCTGA
CCACATCCTTTAGCGAACA -> CACATCCTTTAGCGAACAA
ATGCGCGTGGTACTCCCGT -> TGCGCGTGGTACTCCCGTT
AGGAATGCTCCGGGACTAA -> GGAATGCTCCGGGACTAAG
ATATTCCTCAATTTACCGC -> TATTCCTCAATTTACCGCA
TACCAGTAACTCTGCAGTG -> ACCAGTAACTCTGCAGTGG
GAAAGGTGTTCTACCTTAG -> AAAGGTGTTCTACCTTAGT
CCGGGACTAAGGCCCTGCA -> CGGGACTAAGGCCCTGCAT
TTTGATCTTGACCTCCGAC -> TTGATCTTGACCTCCGACG
TTCCCCCTTACGGTATGTG -> TCCCCCTTACGGTATGTGC
GTCAACAGGTCCCATGAGA -> TCAACAGGTCCCATGAGAA
ATTCACAGTATCAAGATTT -> TTCACAGTATCAAGATTTT
CCTTCCTTAGTAACAAAGA -> CTTCCTTAGTAACAAAGAA
GGGGGTGTTTTGATCTTGA -> GGGGTGTTTTGATCTTGAC
CATCCTTTAGCGAACAAGT -> ATCCTTTAGCGAACAAGTC
TCTTCTTTTTGAGTATGCC -> CTTCTTTTTGAGTATGCCC
CAGATTAGTACTGTCAGCG -> AGATTAGTACTGTCAGCGC
TGGTAACAAATTATGATTC -> GGTAACAAATTATGATTCC
TTTTGTACGTCCTTTCTAT -> TTTGTACGTCCTTTCTATC
CCGAAATTGAGTGGCTCTC -> CGAAATTGAGTGGCTCTCC
ACTACCATCGCCTAGGTAT -> CTACCATCGCCTAGGTATA
CTTAGTAACAAAGAACTTG -> TTAGTAACAAAGAACTTGG
TGTGCTTACGAAGGTTGAT -> GTGCTTACGAAGGTTGATA
TCCCGAAATTGAGTGGCTC -> CCCGAAATTGAGTGGCTCT
GGGCCCATATCCTTAGTAA -> GGCCCATATCCTTAGTAAC
TCTTAGCTTTCATACGGTG -> CTTAGCTTTCATACGGTGC
GTCCGCCCGACTACATCCC -> TCCGCCCGACTACATCCCT
TACCTTAGTAACAAAGAAC -> ACCTTAGTAACAAAGAACT
TGGAGATGGGCGACCCGAT -> GGAGATGGGCGACCCGATC
TATCCTCAAGTGGTAACAA -> ATCCTCAAGTGGTAACAAA
AAAGATGGCCCTAGGGTGC -> AAGATGGCCCTAGGGTGCA
GGCCTGAGATGCATCCTGG -> GCCTGAGATGCATCCTGGG
ATGCGTTGGCCCAAATGGC -> TGCGTTGGCCCAAATGGCA
CTGTGTGTGAATGTCAATA -> TGTGTGTGAATGTCAATAA
TGACGACTGACGTCCATTT -> GACGACTGACGTCCATTTC
AGCGCCAGCTCCCCGCCAA -> GCGCCAGCTCCCCGCCAAA
TCGCTCCTTTTTGTACGTC -> CGCTCCTTTTTGTACGTCC
GCTGAAGTTTATTAATTGC -> CTGAAGTTTATTAATTGCC
CATATGCAATGTTGTATCG -> ATATGCAATGTTGTATCGA
ACATGTGGTATGATGAGCC -> CATGTGGTATGATGAGCCA
TTATACGTTTATCGGTATT -> TATACGTTTATCGGTATTC
AGAATGTTGCGCAGCATAC -> GAATGTTGCGCAGCATACG
GATTCCCCTCTGGGCACGC -> ATTCCCCTCTGGGCACGCT
ACCCTTCCGAAAAACCCAT -> CCCTTCCGAAAAACCCATC
ATGATTCCCCCTTACGGTA -> TGATTCCCCCTTACGGTAT
CGCAATTTAAACACTCGGG -> GCAATTTAAACACTCGGGG
CCCCGCAGGACTACCTTTC -> CCCGCAGGACTACCTTTCA
GGCGTTTGTCCGCCCGACT -> GCGTTTGTCCGCCCGACTA
GAGCCTTAGTAACAAAGAA -> AGCCTTAGTAACAAAGAAC
TTGACCTCCGAGGGGCCCA -> TGACCTCCGAGGGGCCCAT
ATATGTTTGCGGCTCGTAT -> TATGTTTGCGGCTCGTATG
GACTATTATACGTTTATCG -> ACTATTATACGTTTATCGG
AAAGCATTGGGGTGTCAGC -> AAGCATTGGGGTGTCAGCG
TTGGCCCAAATGGCATATG -> TGGCCCAAATGGCATATGT
TATTATACGTTTATCGGTA -> ATTATACGTTTATCGGTAT
TCAATTTACCGCACTATGC -> CAATTTACCGCACTATGCG
GGGGTGAGACGATATCCCT -> GGGTGAGACGATATCCCTT
TGCGTCCGCATGCCACAGT -> GCGTCCGCATGCCACAGTA
AACCTTTGTGCAGCCACTG -> ACCTTTGTGCAGCCACTGG
AACATGTGGTATGATGAGC -> ACATGTGGTATGATGAGCC
CGAAAAACCCATCAATTTA -> GAAAAACCCATCAATTTAG
GTTACGCTATGTGCCCTGT -> TTACGCTATGTGCCCTGTG
AGTACGGTTTAAAAGTCAG -> GTACGGTTTAAAAGTCAGG
GCTCCTTTTTGTACGTCCT -> CTCCTTTTTGTACGTCCTT
GTATCGAGATCATAATCTG -> TATCGAGATCATAATCTGT
TAGGTCTCACGCCCAAGTA -> AGGTCTCACGCCCAAGTAC
ATAGGTCTCACGCCCAAGT -> TAGGTCTCACGCCCAAGTA
TTGCGCAGCATACGCCGGG -> TGCGCAGCATACGCCGGGG
ATAAATGACAGGGCATCTT -> TAAATGACAGGGCATCTTT
TCCGAGTAGATACGGAAAC -> CCGAGTAGATACGGAAACC
ACTGTCAGCGCTTTGCGGG -> CTGTCAGCGCTTTGCGGGT
AAGTCCGCGTCCACTGCAC -> AGTCCGCGTCCACTGCACC
CGGGACCCAAAGATCGCTT -> GGGACCCAAAGATCGCTTT
CATATCCTTAGTAACAAAG -> ATATCCTTAGTAACAAAGA
ATGCATCCTGGGGTGAGAC -> TGCATCCTGGGGTGAGACG
CTTTTCCCAGTAACAATTT -> TTTTCCCAGTAACAATTTG
TGTTCTACCTTAGTAACAA -> GTTCTACCTTAGTAACAAA
GTCTCTGAGGACCCGTAGA -> TCTCTGAGGACCCGTAGAT
TTTCCCAGTAACAATTTGA -> TTCCCAGTAACAATTTGAT
TGACTATTATACGTTTATC -> GACTATTATACGTTTATCG
GTAACAAAGAACTTCGTTT -> TAACAAAGAACTTCGTTTG
CCCCTCTGGGCACGCTTCG -> CCCTCTGGGCACGCTTCGG
TGATAACGAAGTGTAAGGC -> GATAACGAAGTGTAAGGCA
CGTAAACTAAACTGACAGC -> GTAAACTAAACTGACAGCA
CTTCTTGAACGCATGTTTG -> TTCTTGAACGCATGTTTGC
CATCGGGCTAGAATAAAAC -> ATCGGGCTAGAATAAAACA
AGGCGGCGTAGTCTCAGGG -> GGCGGCGTAGTCTCAGGGT
GGCGGCGTAGTCTCAGGGT -> GCGGCGTAGTCTCAGGGTC
CGTTCGTTTACACTGTACA -> GTTCGTTTACACTGTACAA
TGTTTGCCTCAGTTAACGA -> GTTTGCCTCAGTTAACGAG
CATACGGTGCACGAGGTAG -> ATACGGTGCACGAGGTAGG
CGCCAGCTCCCCGCCAAAA -> GCCAGCTCCCCGCCAAAAT
ATCTTGACCTCCGACGTGG -> TCTTGACCTCCGACGTGGA
TCTGTGTGTGAATGTCAAT -> CTGTGTGTGAATGTCAATA
CGGTATTCAGTTTAGGATG -> GGTATTCAGTTTAGGATGT
GGTGCCTTGGATGTTGCCT -> GTGCCTTGGATGTTGCCTC
GTATTCAGTTTAGGATGTT -> TATTCAGTTTAGGATGTTG
GTGGTACTCCCGTTGTCTT -> TGGTACTCCCGTTGTCTTA
TTCAGTTTAGGATGTTGGT -> TCAGTTTAGGATGTTGGTC
CCTCACAGAATAACCTAAT -> CTCACAGAATAACCTAATA
GTATGTGCTTACGAAGGTT -> TATGTGCTTACGAAGGTTG
AGTGTCGCTCCTTTTTGTA -> GTGTCGCTCCTTTTTGTAC
TTTGATTTTGCGTCCGCAT -> TTGATTTTGCGTCCGCATG
AGAGTTAGAGAATGTTGCG -> GAGTTAGAGAATGTTGCGC
ACCTCAACGCAACCTAATT -> CCTCAACGCAACCTAATTG
GGCAGGTAGTAGGGCTGAA -> GCAGGTAGTAGGGCTGAAG
CACTGACTATTATACGTTT -> ACTGACTATTATACGTTTA
TGGTCGGATCATCGCGATG -> GGTCGGATCATCGCGATGC
GTAACAATTTGATCTTGAC -> TAACAATTTGATCTTGACC
GGAATCCTGACGACTGACG -> GAATCCTGACGACTGACGT
CAGTATCAAGATTTTGGTC -> AGTATCAAGATTTTGGTCA
CATCTTTGATTTTGCGTCC -> ATCTTTGATTTTGCGTCCG
CATTTCTTAGCTTTCATAC -> ATTTCTTAGCTTTCATACG
GGGAACCTATGATAACGAA -> GGAACCTATGATAACGAAG
ATTCAGTTTAGGATGTTGG -> TTCAGTTTAGGATGTTGGT
CACCTCAACGCAACCTAAT -> ACCTCAACGCAACCTAATT
GCAATCGCCTCCAACACTT -> CAATCGCCTCCAACACTTT
GATAACGAAGTGTAAGGCA -> ATAACGAAGTGTAAGGCAA
GCGCAGCATACGCCGGGGG -> CGCAGCATACGCCGGGGGG
CGAACAAGTCACGGGACTG -> GAACAAGTCACGGGACTGG
CCTTTGAGCGGTTAGTGCA -> CTTTGAGCGGTTAGTGCAT
TGGTCAACAGGTCCCATGA -> GGTCAACAGGTCCCATGAG
ATCCTTCCTTAGTAACAAA -> TCCTTCCTTAGTAACAAAG
GGACCTCAGTTACTACCAT -> GACCTCAGTTACTACCATC
AAGTGGTAACAAATTATGA -> AGTGGTAACAAATTATGAT
GTGGATCCTTCCTTAGTAA -> TGGATCCTTCCTTAGTAAC
GACGTCCATTTCTTAGCTT -> ACGTCCATTTCTTAGCTTT
GTAGTAGGGCTGAAGTTTA -> TAGTAGGGCTGAAGTTTAT
TGTGAGGCGTTTGTCCGCC -> GTGAGGCGTTTGTCCGCCC
TAACGAAGTGTAAGGCAAG -> AACGAAGTGTAAGGCAAGT
GTCACGGGACTGGTCGGAT -> TCACGGGACTGGTCGGATC
TGGGTACCGGCGTTCGTTT -> GGGTACCGGCGTTCGTTTA
TCCATTTCTTAGCTTTCAT -> CCATTTCTTAGCTTTCATA
TAATCTGTGTACTCATATC -> AATCTGTGTACTCATATCC
TCGAGTATGATTGAGTAAA -> CGAGTATGATTGAGTAAAC
TGTCAATAACCATGGCACC -> GTCAATAACCATGGCACCG
CAATTTGATCTTGACCTCC -> AATTTGATCTTGACCTCCG
TAACTCTGCAGTGGTATAT -> AACTCTGCAGTGGTATATA
GCGTTTTCCTGCTGGTAGA -> CGTTTTCCTGCTGGTAGAT
CTGTGAGGCGTTTGTCCGC -> TGTGAGGCGTTTGTCCGCC
CAACGACAAGGCGTGGTGG -> AACGACAAGGCGTGGTGGG
CAACGCAACCTAATTGAGG -> AACGCAACCTAATTGAGGA
ATTTAAACACTCGGGGTCA -> TTTAAACACTCGGGGTCAA
ACGAAGGTTGATAGTTTGA -> CGAAGGTTGATAGTTTGAT
TTGTATTAGATTCCGAGTA -> TGTATTAGATTCCGAGTAG
TTCCTGCTGGTAGATGACG -> TCCTGCTGGTAGATGACGC
CCACTGGAGATGGGGTTAC -> CACTGGAGATGGGGTTACG
CTCACGATGACGCGTTTTC -> TCACGATGACGCGTTTTCC
GACTGACGTCCATTTCTTA -> ACTGACGTCCATTTCTTAG
GATTTTGCGTCCGCATGCC -> ATTTTGCGTCCGCATGCCA
CGGGAACCTATGATAACGA -> GGGAACCTATGATAACGAA
TTACGGTATGTGCTTACGA -> TACGGTATGTGCTTACGAA
CGTGGATCCTTCCTTAGTA -> GTGGATCCTTCCTTAGTAA
TCAAGTGGTAACAAATTAT -> CAAGTGGTAACAAATTATG
AACAAATTATGATTCCCCC -> ACAAATTATGATTCCCCCT
GTAACAAAGAACTTCCACG -> TAACAAAGAACTTCCACGT
TAGATACGCCAGAAACGTA -> AGATACGCCAGAAACGTAC
CTCTCAGGGGGGTGTTTTG -> TCTCAGGGGGGTGTTTTGA
TTCGCCGGACGGCCTGAGA -> TCGCCGGACGGCCTGAGAT
CCCCTTACGGTATGTGCTT -> CCCTTACGGTATGTGCTTA
GTATGATGAGCCACCCTTC -> TATGATGAGCCACCCTTCC
GCGGTATGGGTCCGGGTAG -> CGGTATGGGTCCGGGTAGG
GCCACAGTATCGAGATCAT -> CCACAGTATCGAGATCATA
TTAGAGAATGTTGCGCAGC -> TAGAGAATGTTGCGCAGCA
AGTTTATTAATTGCCCTGA -> GTTTATTAATTGCCCTGAG
GGCACCTTCTTTTCGCCGG -> GCACCTTCTTTTCGCCGGA
GTAACTCTGCAGTGGTATA -> TAACTCTGCAGTGGTATAT
CCGAGTAGATACGGAAACC -> CGAGTAGATACGGAAACCT
AGATCGCTTTTTTCCTACC -> GATCGCTTTTTTCCTACCA
ATGTTTGCCTCAGTTAACG -> TGTTTGCCTCAGTTAACGA
ATGTCAATAACCATGGCAC -> TGTCAATAACCATGGCACC
ACGAAGTGTAAGGCAAGTC -> CGAAGTGTAAGGCAAGTCC
TAAGGCAAGTCCGCGTCCA -> AAGGCAAGTCCGCGTCCAC
TGGACCTCAGTTACTACCA -> GGACCTCAGTTACTACCAT
TGTCTTATTGTATTAGATT -> GTCTTATTGTATTAGATTC
CGAAGGTTGATAGTTTGAT -> GAAGGTTGATAGTTTGATC
GTATATAGCGGTATGGGTC -> TATATAGCGGTATGGGTCC
TTGAACGCATGTTTGCCTC -> TGAACGCATGTTTGCCTCA
GGTCTCACGCCCAAGTACG -> GTCTCACGCCCAAGTACGG
TAGTAGGGCTGAAGTTTAT -> AGTAGGGCTGAAGTTTATT
TGGTAGATGACGCAATGGA -> GGTAGATGACGCAATGGAG
ATTAATTGCCCTGAGTGTC -> TTAATTGCCCTGAGTGTCG
GATATTCCTCAATTTACCG -> ATATTCCTCAATTTACCGC
ATAAAGCATCGGGCTAGAA -> TAAAGCATCGGGCTAGAAT
AGTCCGCGTCCACTGCACC -> GTCCGCGTCCACTGCACCG
CGGCCTGAGATGCATCCTG -> GGCCTGAGATGCATCCTGG
ATTTTGCGTCCGCATGCCA -> TTTTGCGTCCGCATGCCAC
AGAGAATGTTGCGCAGCAT -> GAGAATGTTGCGCAGCATA
CGATCAGGGTGGAGCCTTA -> GATCAGGGTGGAGCCTTAG
GACCCGATCTGTGTGTGAA -> ACCCGATCTGTGTGTGAAT
CAACACAAAGCATTGGGGT -> AACACAAAGCATTGGGGTG
CTACCTTTCACGCTGTGCG -> TACCTTTCACGCTGTGCGG
TACGCTATGTGCCCTGTGA -> ACGCTATGTGCCCTGTGAG
GCCCTGAGTGTCGCTCCTT -> CCCTGAGTGTCGCTCCTTT
ACATCCGATATTCCTCAAT -> CATCCGATATTCCTCAATT
TATCGGTATTCAGTTTAGG -> ATCGGTATTCAGTTTAGGA
GGAACGGAACGGGACCCAA -> GAACGGAACGGGACCCAAA
CGGCTCGTATGTCACTATA -> GGCTCGTATGTCACTATAT
CCTTAGCGCCAGCTCCCCG -> CTTAGCGCCAGCTCCCCGC
GCCCGTTCACCTCAACGCA -> CCCGTTCACCTCAACGCAA
AGTAGATACGGAAACCTTG -> GTAGATACGGAAACCTTGC
GCGTTTGTCCGCCCGACTA -> CGTTTGTCCGCCCGACTAC
GGGTTGTTGCCCGGAATCC -> GGTTGTTGCCCGGAATCCC
GCGTTGGCCCAAATGGCAT -> CGTTGGCCCAAATGGCATA
CCATGGCACCGGACATCTT -> CATGGCACCGGACATCTTC
ATGTGCCCTGTGAGGCGTT -> TGTGCCCTGTGAGGCGTTT
TCTTGACCTCCGATCAGGG -> CTTGACCTCCGATCAGGGT
TCTCAGGGGGGTGTTTTGA -> CTCAGGGGGGTGTTTTGAT
AAACGTACTTTTTGTTCGC -> AACGTACTTTTTGTTCGCA
AGGTGTTCTACCTTAGTAA -> GGTGTTCTACCTTAGTAAC
GGAGATGGGCGACCCGATC -> GAGATGGGCGACCCGATCT
TTGACCTCCGAAAGGTGTT -> TGACCTCCGAAAGGTGTTC
CGACCCGATCTGTGTGTGA -> GACCCGATCTGTGTGTGAA
TCACAGAATAACCTAATAG -> CACAGAATAACCTAATAGG
TCTTCAGCCCCGCAGGACT -> CTTCAGCCCCGCAGGACTA
CAGGTAACCTTTGTGCAGC -> AGGTAACCTTTGTGCAGCC
CCGGGGGGGTAGGAGATAT -> CGGGGGGGTAGGAGATATC
GTTTACACTGTACAAGACC -> TTTACACTGTACAAGACCT
TGACGTCCATTTCTTAGCT -> GACGTCCATTTCTTAGCTT
TGTTGCCTCTCAGGGGGGT -> GTTGCCTCTCAGGGGGGTG
GACCTCCGATCAGGGTGGA -> ACCTCCGATCAGGGTGGAG
GCATACGCACTGACTATTA -> CATACGCACTGACTATTAT
GTGTGTGAATGTCAATAAC -> TGTGTGAATGTCAATAACC
TATCAAGATTTTGGTCAAC -> ATCAAGATTTTGGTCAACA
GAGTGCATACGCACTGACT -> AGTGCATACGCACTGACTA
ACACAAAGCATTGGGGTGT -> CACAAAGCATTGGGGTGTC
AGGCGTGGTGGGGTGTCAT -> GGCGTGGTGGGGTGTCATA
AGATGGGCGACCCGATCTG -> GATGGGCGACCCGATCTGT
GTACGTCCTTTCTATCGAG -> TACGTCCTTTCTATCGAGT
TATTAATTGCCCTGAGTGT -> ATTAATTGCCCTGAGTGTC
TAGTGCATACTGGAGATAA -> AGTGCATACTGGAGATAAC
GTACTCATATCCAAGTCCC -> TACTCATATCCAAGTCCCG
CACAGTATCGAGATCATAA -> ACAGTATCGAGATCATAAT
GGTTTAAAAGTCAGGTAAC -> GTTTAAAAGTCAGGTAACC
GCATACGCCGGGGGGGTAG -> CATACGCCGGGGGGGTAGG
AATGGATGCTGGACTGACA -> ATGGATGCTGGACTGACAG
GGGTGTCAGCGAACCCGAA -> GGTGTCAGCGAACCCGAAA
GCATATGTTTGCGGCTCGT -> CATATGTTTGCGGCTCGTA
AGTCTAGAACCTGCCCGTT -> GTCTAGAACCTGCCCGTTC
TTCCTCAATTTACCGCACT -> TCCTCAATTTACCGCACTA
TCGCCTAGGTATAAAGCAT -> CGCCTAGGTATAAAGCATC
GTATCAAGATTTTGGTCAA -> TATCAAGATTTTGGTCAAC
AGTAACTCTGCAGTGGTAT -> GTAACTCTGCAGTGGTATA
CGGACGGCCTGAGATGCAT -> GGACGGCCTGAGATGCATC
CCGACGTGGATCCTTCCTT -> CGACGTGGATCCTTCCTTA
TGGCACCGGACATCTTCTT -> GGCACCGGACATCTTCTTT
GTCCATATGCAATGTTGTA -> TCCATATGCAATGTTGTAT
TTGTCCAAGCTTTTCCCAG -> TGTCCAAGCTTTTCCCAGT
TGCTTACGAAGGTTGATAG -> GCTTACGAAGGTTGATAGT
CTATTATACGTTTATCGGT -> TATTATACGTTTATCGGTA
CAGGTCCCATGAGAACGTT -> AGGTCCCATGAGAACGTTT
GCACTATGCGTTGGCCCAA -> CACTATGCGTTGGCCCAAA
GAGACGATATCCCTTGCTT -> AGACGATATCCCTTGCTTT
GCAGTGGTATATAGCGGTA -> CAGTGGTATATAGCGGTAT
GCTCCCCGCCAAAATTCAC -> CTCCCCGCCAAAATTCACA
CTTTAGCGAACAAGTCACG -> TTTAGCGAACAAGTCACGG
TGATTGAGTAAACCTTAGC -> GATTGAGTAAACCTTAGCG
GCACCGTCCATATGCAATG -> CACCGTCCATATGCAATGT
TTGATCTTGACCTCCGAAA -> TGATCTTGACCTCCGAAAG
CTGTCAGCGCTTTGCGGGT -> TGTCAGCGCTTTGCGGGTT
GACTAAGGCCCTGCATCCC -> ACTAAGGCCCTGCATCCCT
TCCCATGAGAACGTTTGTC -> CCCATGAGAACGTTTGTCC
CCTAATTGAGGAATGCTCC -> CTAATTGAGGAATGCTCCG
GTTAGAGAATGTTGCGCAG -> TTAGAGAATGTTGCGCAGC
AGGGTGGAGCCTTAGTAAC -> GGGTGGAGCCTTAGTAACA
AAAGATCGCTTTTTTCCTA -> AAGATCGCTTTTTTCCTAC
GAATGCTCCGGGACTAAGG -> AATGCTCCGGGACTAAGGC
TCTATCGAGTATGATTGAG -> CTATCGAGTATGATTGAGT
CCTATGATAACGAAGTGTA -> CTATGATAACGAAGTGTAA
GACGGAAGTCTAGAACCTG -> ACGGAAGTCTAGAACCTGC
GCTTTGATCTTGACCTCCG -> CTTTGATCTTGACCTCCGA
GATGGGGTTACGCTATGTG -> ATGGGGTTACGCTATGTGC
CCCTGAGTGTCGCTCCTTT -> CCTGAGTGTCGCTCCTTTT
CGTGGTGGGGTGTCATATG -> GTGGTGGGGTGTCATATGG
GTAAACTAAACTGACAGCA -> TAAACTAAACTGACAGCAT
GGTATGATGAGCCACCCTT -> GTATGATGAGCCACCCTTC
CTTGGCGGCAGGTAGTAGG -> TTGGCGGCAGGTAGTAGGG
ATCGGGCTAGAATAAAACA -> TCGGGCTAGAATAAAACAT
CCTTTAGCGAACAAGTCAC -> CTTTAGCGAACAAGTCACG
TTTGCGGCTCGTATGTCAC -> TTGCGGCTCGTATGTCACT
AAGTTTATTAATTGCCCTG -> AGTTTATTAATTGCCCTGA
TATAAGACGTTCGCAATAG -> ATAAGACGTTCGCAATAGA
GAGTAGATACGGAAACCTT -> AGTAGATACGGAAACCTTG
CGTATCCGGGCACCTTCTT -> GTATCCGGGCACCTTCTTT
GGTCCGACGGGTCTATAAA -> GTCCGACGGGTCTATAAAT
GTATCGACACAGGATCGAG -> TATCGACACAGGATCGAGC
ACTACATCCCTGTCGATTA -> CTACATCCCTGTCGATTAA
CGTTCGCAATAGATGGGTA -> GTTCGCAATAGATGGGTAC
CCCCAGAAGAGTACAGGCC -> CCCAGAAGAGTACAGGCCT
CGGGATGCTTCTTCAGCCC -> GGGATGCTTCTTCAGCCCC
TGTGGTATGATGAGCCACC -> GTGGTATGATGAGCCACCC
ATAACATGTGGTATGATGA -> TAACATGTGGTATGATGAG
TAGTTTGATCTTGACCTCC -> AGTTTGATCTTGACCTCCG
GCGTCACGGTCTCTGAGGA -> CGTCACGGTCTCTGAGGAC
TCCGATATTCCTCAATTTA -> CCGATATTCCTCAATTTAC
GACGGGTCTATAAATGACA -> ACGGGTCTATAAATGACAG
GGTTGTTGCCCGGAATCCC -> GTTGTTGCCCGGAATCCCA
GTTGGTCTGCAACCCCAGA -> TTGGTCTGCAACCCCAGAA
TGTTCGCAGATTAGTACTG -> GTTCGCAGATTAGTACTGT
CAGGCGGCGTAGTCTCAGG -> AGGCGGCGTAGTCTCAGGG
ATCCGGGCACCTTCTTTTC -> TCCGGGCACCTTCTTTTCG
GATCTTGACCTCCGAAAGG -> ATCTTGACCTCCGAAAGGT
TGGACTGACAGCAACGACA -> GGACTGACAGCAACGACAA
TCAGGTAACCTTTGTGCAG -> CAGGTAACCTTTGTGCAGC
GCCCATATCCTTAGTAACA -> CCCATATCCTTAGTAACAA
GTCTGCAACCCCAGAAGAG -> TCTGCAACCCCAGAAGAGT
AATCTGTGTACTCATATCC -> ATCTGTGTACTCATATCCA
TTTTCCCAGTAACAATTTG -> TTTCCCAGTAACAATTTGA
GTCAGGTAACCTTTGTGCA -> TCAGGTAACCTTTGTGCAG
TGGCATATGTTTGCGGCTC -> GGCATATGTTTGCGGCTCG
AATTTAGGATTCCCCTCTG -> ATTTAGGATTCCCCTCTGG
GCACCCTTTGAGCGGTTAG -> CACCCTTTGAGCGGTTAGT
CAACCCCAGAAGAGTACAG -> AACCCCAGAAGAGTACAGG
AAATTTAGCTGCGGGATGC -> AATTTAGCTGCGGGATGCT
CTCCGGGACTAAGGCCCTG -> TCCGGGACTAAGGCCCTGC
CTTTGAGCGGTTAGTGCAT -> TTTGAGCGGTTAGTGCATA
GCAGCATACGCCGGGGGGG -> CAGCATACGCCGGGGGGGT
AGCGCTTTGCGGGTTGTTG -> GCGCTTTGCGGGTTGTTGC
AAAACATCCGATATTCCTC -> AAACATCCGATATTCCTCA
CCGAAAGGTGTTCTACCTT -> CGAAAGGTGTTCTACCTTA
TCCTGACGACTGACGTCCA -> CCTGACGACTGACGTCCAT
CCCGTAAACTAAACTGACA -> CCGTAAACTAAACTGACAG
CTATAAATGACAGGGCATC -> TATAAATGACAGGGCATCT
TTTGTCCCGCAATTTAAAC -> TTGTCCCGCAATTTAAACA
TGAGTATGCCCCTGTAATG -> GAGTATGCCCCTGTAATGG
TCAGCCCCGCAGGACTACC -> CAGCCCCGCAGGACTACCT
TTTTTGAGTATGCCCCTGT -> TTTTGAGTATGCCCCTGTA
CATATGGGGGAATCCTGAC -> ATATGGGGGAATCCTGACG
GGCCCATATCCTTAGTAAC -> GCCCATATCCTTAGTAACA
ACCTGCCCGTTCACCTCAA -> CCTGCCCGTTCACCTCAAC
GGGGGTAGGAGATATCCTC -> GGGGTAGGAGATATCCTCA
TGGGCACGCTTCGGATGCG -> GGGCACGCTTCGGATGCGT
TTGCTTTGATCTTGACCTC -> TGCTTTGATCTTGACCTCC
CTGAAGTTTATTAATTGCC -> TGAAGTTTATTAATTGCCC
TCTAGAACCTGCCCGTTCA -> CTAGAACCTGCCCGTTCAC
CCCTTACGGTATGTGCTTA -> CCTTACGGTATGTGCTTAC
AGTAAATGGATGCTGGACT -> GTAAATGGATGCTGGACTG
CAGGTAGTAGGGCTGAAGT -> AGGTAGTAGGGCTGAAGTT
GTGGCTCTCCTGGACCTCA -> TGGCTCTCCTGGACCTCAG
ATCAAGATTTTGGTCAACA -> TCAAGATTTTGGTCAACAG
TAATTGAGGAATGCTCCGG -> AATTGAGGAATGCTCCGGG
CTGAGGACCCGTAGATACG -> TGAGGACCCGTAGATACGC
AGCTCATGTGCAAATATTG -> GCTCATGTGCAAATATTGT
CAATCGCCTCCAACACTTT -> AATCGCCTCCAACACTTTC
GACCTCCGAAAGGTGTTCT -> ACCTCCGAAAGGTGTTCTA
GCTATGTGCCCTGTGAGGC -> CTATGTGCCCTGTGAGGCG
ACAGGCCTATTAGAGTTAG -> CAGGCCTATTAGAGTTAGA
TGGGAACGGAACGGGACCC -> GGGAACGGAACGGGACCCA
CGCACTGACTATTATACGT -> GCACTGACTATTATACGTT
ACCATGGCACCGGACATCT -> CCATGGCACCGGACATCTT
CCTCTGGGCACGCTTCGGA -> CTCTGGGCACGCTTCGGAT
TTGACCTCCGACGTGGATC -> TGACCTCCGACGTGGATCC
CGATGACGCGTTTTCCTGC -> GATGACGCGTTTTCCTGCT
TCTCTGAGGACCCGTAGAT -> CTCTGAGGACCCGTAGATA
CCCGCCAAAATTCACAGTA -> CCGCCAAAATTCACAGTAT
AGATACGGAAACCTTGCAG -> GATACGGAAACCTTGCAGT
GATGGCCCTAGGGTGCAAC -> ATGGCCCTAGGGTGCAACG
GGGCTGAAGTTTATTAATT -> GGCTGAAGTTTATTAATTG
GAAACCTTGCAGTAAATGG -> AAACCTTGCAGTAAATGGA
GTAGGCCAGGCGGCGTAGT -> TAGGCCAGGCGGCGTAGTC
TTTGATCTTGACCTCCGAA -> TTGATCTTGACCTCCGAAA
TTTGGTCAACAGGTCCCAT -> TTGGTCAACAGGTCCCATG
TCTTGACCTCCGACGTGGA -> CTTGACCTCCGACGTGGAT
CACCCTTCCGAAAAACCCA -> ACCCTTCCGAAAAACCCAT
CATACGCACTGACTATTAT -> ATACGCACTGACTATTATA
ATCCTCAAGTGGTAACAAA -> TCCTCAAGTGGTAACAAAT
CCGGCGTTCGTTTACACTG -> CGGCGTTCGTTTACACTGT
GGAGATAACATGTGGTATG -> GAGATAACATGTGGTATGA
CCACCCTTCCGAAAAACCC -> CACCCTTCCGAAAAACCCA
CGGAAACCTTGCAGTAAAT -> GGAAACCTTGCAGTAAATG
TAGGTATAAAGCATCGGGC -> AGGTATAAAGCATCGGGCT
TGAGGACCCGTAGATACGC -> GAGGACCCGTAGATACGCC
GCGATCCCCAGACCTTCTT -> CGATCCCCAGACCTTCTTG
GTACCGGCGTTCGTTTACA -> TACCGGCGTTCGTTTACAC
TCTTTGATTTTGCGTCCGC -> CTTTGATTTTGCGTCCGCA
GTGGAGCCTTAGTAACAAA -> TGGAGCCTTAGTAACAAAG
GAGTAAACCTTAGCGCCAG -> AGTAAACCTTAGCGCCAGC
ATTGAGTAAACCTTAGCGC -> TTGAGTAAACCTTAGCGCC
GCGGTTAGTGCATACTGGA -> CGGTTAGTGCATACTGGAG
ACGGAACGGGACCCAAAGA -> CGGAACGGGACCCAAAGAT
TCGCTTTTTTCCTACCAGT -> CGCTTTTTTCCTACCAGTA
ACGTGGATCCTTCCTTAGT -> CGTGGATCCTTCCTTAGTA
CAAGTCCCGTAAACTAAAC -> AAGTCCCGTAAACTAAACT
AGTGGCTCTCCTGGACCTC -> GTGGCTCTCCTGGACCTCA
GATGAGCCACCCTTCCGAA -> ATGAGCCACCCTTCCGAAA
CATCGCGATGCGCGTGGTA -> ATCGCGATGCGCGTGGTAC
CCTGCTGGTAGATGACGCA -> CTGCTGGTAGATGACGCAA
GTGCGGGAACCTATGATAA -> TGCGGGAACCTATGATAAC
TCAGGGGGGTGTTTTGATC -> CAGGGGGGTGTTTTGATCT
CAGGGTCCGACGGGTCTAT -> AGGGTCCGACGGGTCTATA
ACCGGCGTTCGTTTACACT -> CCGGCGTTCGTTTACACTG
TACTCCCGTTGTCTTATTG -> ACTCCCGTTGTCTTATTGT
GTAATCGTATCCGGGCACC -> TAATCGTATCCGGGCACCT
GGTCTATAAATGACAGGGC -> GTCTATAAATGACAGGGCA
TCCTGGGGTGAGACGATAT -> CCTGGGGTGAGACGATATC
GACTACCTTTCACGCTGTG -> ACTACCTTTCACGCTGTGC
GCATCGGGCTAGAATAAAA -> CATCGGGCTAGAATAAAAC
GTACTTTTTGTTCGCAGAT -> TACTTTTTGTTCGCAGATT
GTGAGGCGTTTGTCCGCCC -> TGAGGCGTTTGTCCGCCCG
GTCAATAACCATGGCACCG -> TCAATAACCATGGCACCGG
AACTTCCACGTATCTGATG -> ACTTCCACGTATCTGATGA
TCAAGATTTTGGTCAACAG -> CAAGATTTTGGTCAACAGG
CTTTTTTCCTACCAGTAAC -> TTTTTTCCTACCAGTAACT
TAGGTAATCGTATCCGGGC -> AGGTAATCGTATCCGGGCA
ATTGTATTAGATTCCGAGT -> TTGTATTAGATTCCGAGTA
CCGCACTATGCGTTGGCCC -> CGCACTATGCGTTGGCCCA
TTCGTTTGTCCAAGCTTTT -> TCGTTTGTCCAAGCTTTTC
CTTGCAGTAAATGGATGCT -> TTGCAGTAAATGGATGCTG
GAACGCATGTTTGCCTCAG -> AACGCATGTTTGCCTCAGT
AGGGCATCTTTGATTTTGC -> GGGCATCTTTGATTTTGCG
GGGGCCCATATCCTTAGTA -> GGGCCCATATCCTTAGTAA
CTTTTTGTTCGCAGATTAG -> TTTTTGTTCGCAGATTAGT
TAACAAAGAACTTAAGTGC -> AACAAAGAACTTAAGTGCA
TGAAGTTTATTAATTGCCC -> GAAGTTTATTAATTGCCCT
TTGATTTTGCGTCCGCATG -> TGATTTTGCGTCCGCATGC
TTTGTGCAGCCACTGGAGA -> TTGTGCAGCCACTGGAGAT
TGTCCAAGCTTTTCCCAGT -> GTCCAAGCTTTTCCCAGTA
CTGGAGATGGGGTTACGCT -> TGGAGATGGGGTTACGCTA
CCACGTATCTGATGAGTGC -> CACGTATCTGATGAGTGCA
CCCGATCTGTGTGTGAATG -> CCGATCTGTGTGTGAATGT
ACCTTCTTTTCGCCGGACG -> CCTTCTTTTCGCCGGACGG
GGCGACCCGATCTGTGTGT -> GCGACCCGATCTGTGTGTG
AGGTATAAAGCATCGGGCT -> GGTATAAAGCATCGGGCTA
CCCATCAATTTAGGATTCC -> CCATCAATTTAGGATTCCC
AAATGGATGCTGGACTGAC -> AATGGATGCTGGACTGACA
CCATCAATTTAGGATTCCC -> CATCAATTTAGGATTCCCC
TCACAGTATCAAGATTTTG -> CACAGTATCAAGATTTTGG
AGATTAGTACTGTCAGCGC -> GATTAGTACTGTCAGCGCT
CACGATGACGCGTTTTCCT -> ACGATGACGCGTTTTCCTG
ATCCCTTGCTTTGATCTTG -> TCCCTTGCTTTGATCTTGA
AGTGGTATATAGCGGTATG -> GTGGTATATAGCGGTATGG
ACCTTAGTAACAAAGAACT -> CCTTAGTAACAAAGAACTT
TCTGATGAGTGCATACGCA -> CTGATGAGTGCATACGCAC
CCTCCGAAAGGTGTTCTAC -> CTCCGAAAGGTGTTCTACC
AAGATGGCCCTAGGGTGCA -> AGATGGCCCTAGGGTGCAA
CTCCGATCAGGGTGGAGCC -> TCCGATCAGGGTGGAGCCT
CAGCCACATCCTTTAGCGA -> AGCCACATCCTTTAGCGAA
AGGCGATCCCCAGACCTTC -> GGCGATCCCCAGACCTTCT
ACAAATTATGATTCCCCCT -> CAAATTATGATTCCCCCTT
GAACCTATGATAACGAAGT -> AACCTATGATAACGAAGTG
CGTTGGCCCAAATGGCATA -> GTTGGCCCAAATGGCATAT
TTGCCCGGAATCCCAGCTC -> TGCCCGGAATCCCAGCTCA
CCTCAACGCAACCTAATTG -> CTCAACGCAACCTAATTGA
GGAGATATCCTCAAGTGGT -> GAGATATCCTCAAGTGGTA
TGCGCGTGGTACTCCCGTT -> GCGCGTGGTACTCCCGTTG
CGATGCGCGTGGTACTCCC -> GATGCGCGTGGTACTCCCG
ATATCCCTTGCTTTGATCT -> TATCCCTTGCTTTGATCTT
AGTAACAAAGAACTTCGTT -> GTAACAAAGAACTTCGTTT
CGGGGGGGTAGGAGATATC -> GGGGGGGTAGGAGATATCC
ATAAAACATCCGATATTCC -> TAAAACATCCGATATTCCT
TCAATAACCATGGCACCGG -> CAATAACCATGGCACCGGA
CAGTGGTATATAGCGGTAT -> AGTGGTATATAGCGGTATG
TATATAAGACGTTCGCAAT -> ATATAAGACGTTCGCAATA
GGGCATCTTTGATTTTGCG -> GGCATCTTTGATTTTGCGT
GGTAACAAATTATGATTCC -> GTAACAAATTATGATTCCC
CGTAGTCTCAGGGTCCGAC -> GTAGTCTCAGGGTCCGACG
CGTCCACTGCACCGTCCAT -> GTCCACTGCACCGTCCATA
GAACGTTTGTCCCGCAATT -> AACGTTTGTCCCGCAATTT
AGCAACGACAAGGCGTGGT -> GCAACGACAAGGCGTGGTG
ATAACGAAGTGTAAGGCAA -> TAACGAAGTGTAAGGCAAG
ATGTCACTATATAAGACGT -> TGTCACTATATAAGACGTT
GAACTTGGCGGCAGGTAGT -> AACTTGGCGGCAGGTAGTA
GTACAGGCCTATTAGAGTT -> TACAGGCCTATTAGAGTTA
TCCCAGCTCATGTGCAAAT -> CCCAGCTCATGTGCAAATA
GACCTCTCACGATGACGCG -> ACCTCTCACGATGACGCGT
TACTGGAGATAACATGTGG -> ACTGGAGATAACATGTGGT
GCCACATCCTTTAGCGAAC -> CCACATCCTTTAGCGAACA
GCACGAGGTAGGCGATCCC -> CACGAGGTAGGCGATCCCC
CGCATGCCACAGTATCGAG -> GCATGCCACAGTATCGAGA
AGTAACAAAGAACTTCCAC -> GTAACAAAGAACTTCCACG
AACGGGACCCAAAGATCGC -> ACGGGACCCAAAGATCGCT
TCCCGCAATTTAAACACTC -> CCCGCAATTTAAACACTCG
AAGCATCGGGCTAGAATAA -> AGCATCGGGCTAGAATAAA
CTAGGTATAAAGCATCGGG -> TAGGTATAAAGCATCGGGC
AATTGAGGAATGCTCCGGG -> ATTGAGGAATGCTCCGGGA
GTTGGCCCAAATGGCATAT -> TTGGCCCAAATGGCATATG
GCCTCCAACACTTTCAAAT -> CCTCCAACACTTTCAAATT
ATTGAGTGGCTCTCCTGGA -> TTGAGTGGCTCTCCTGGAC
TTAGCTGCGGGATGCTTCT -> TAGCTGCGGGATGCTTCTT
CTAATAGGTCTCACGCCCA -> TAATAGGTCTCACGCCCAA
TGAGTAAACCTTAGCGCCA -> GAGTAAACCTTAGCGCCAG
ATGCCACAGTATCGAGATC -> TGCCACAGTATCGAGATCA
AACGCATGTTTGCCTCAGT -> ACGCATGTTTGCCTCAGTT
GCGATGCGCGTGGTACTCC -> CGATGCGCGTGGTACTCCC
GCTGGTAGATGACGCAATG -> CTGGTAGATGACGCAATGG
CTAAACTGACAGCATATTC -> TAAACTGACAGCATATTCT
GTCAGCGCTTTGCGGGTTG -> TCAGCGCTTTGCGGGTTGT
GTATGCCCCTGTAATGGGA -> TATGCCCCTGTAATGGGAA
CGCAATAGATGGGTACCGG -> GCAATAGATGGGTACCGGC
ATAGATGGGTACCGGCGTT -> TAGATGGGTACCGGCGTTC
CTTAGTAACAAAGAACTTA -> TTAGTAACAAAGAACTTAA
TCACTATATAAGACGTTCG -> CACTATATAAGACGTTCGC
CACAGAATAACCTAATAGG -> ACAGAATAACCTAATAGGT
TAACGAGGTGCCTTGGATG -> AACGAGGTGCCTTGGATGT
GACGCAATGGAGATGGGCG -> ACGCAATGGAGATGGGCGA
AGGGGGGTGTTTTGATCTT -> GGGGGGTGTTTTGATCTTG
TAGATACGGAAACCTTGCA -> AGATACGGAAACCTTGCAG
GAACGGGACCCAAAGATCG -> AACGGGACCCAAAGATCGC
GGATCATCGCGATGCGCGT -> GATCATCGCGATGCGCGTG
TTAAGTGCACCCTTTGAGC -> TAAGTGCACCCTTTGAGCG
CTAGGGTGCAACGCAATCG -> TAGGGTGCAACGCAATCGC
ACGTTCGCAATAGATGGGT -> CGTTCGCAATAGATGGGTA
GGAAACCTTGCAGTAAATG -> GAAACCTTGCAGTAAATGG
AGGTCTCACGCCCAAGTAC -> GGTCTCACGCCCAAGTACG
CGTATGTCACTATATAAGA -> GTATGTCACTATATAAGAC
TCCCTCACAGAATAACCTA -> CCCTCACAGAATAACCTAA
TCATATGGGGGAATCCTGA -> CATATGGGGGAATCCTGAC
CTGGTAGATGACGCAATGG -> TGGTAGATGACGCAATGGA
CACGCTGTGCGGGAACCTA -> ACGCTGTGCGGGAACCTAT
CAGTTACTACCATCGCCTA -> AGTTACTACCATCGCCTAG
AGCGGTATGGGTCCGGGTA -> GCGGTATGGGTCCGGGTAG
GTCCATTTCTTAGCTTTCA -> TCCATTTCTTAGCTTTCAT
GTGCCCTGTGAGGCGTTTG -> TGCCCTGTGAGGCGTTTGT
ATTGGGGTGTCAGCGAACC -> TTGGGGTGTCAGCGAACCC
CAACAGGTCCCATGAGAAC -> AACAGGTCCCATGAGAACG
TCCGGGCACCTTCTTTTCG -> CCGGGCACCTTCTTTTCGC
CGAAATTGAGTGGCTCTCC -> GAAATTGAGTGGCTCTCCT
CAAATTTAGCTGCGGGATG -> AAATTTAGCTGCGGGATGC
CTTTGATTTTGCGTCCGCA -> TTTGATTTTGCGTCCGCAT
TTTTGAGTATGCCCCTGTA -> TTTGAGTATGCCCCTGTAA
AGTCCCGTAAACTAAACTG -> GTCCCGTAAACTAAACTGA
TTTCGCCGGACGGCCTGAG -> TTCGCCGGACGGCCTGAGA
TTTTCCTACCAGTAACTCT -> TTTCCTACCAGTAACTCTG
CACGAGGTAGGCGATCCCC -> ACGAGGTAGGCGATCCCCA
TAGAGAATGTTGCGCAGCA -> AGAGAATGTTGCGCAGCAT
GCTCTCCTGGACCTCAGTT -> CTCTCCTGGACCTCAGTTA
TATCGAGTATGATTGAGTA -> ATCGAGTATGATTGAGTAA
GGCCAGGCGGCGTAGTCTC -> GCCAGGCGGCGTAGTCTCA
TTAGTGCATACTGGAGATA -> TAGTGCATACTGGAGATAA
CAGGGGGGTGTTTTGATCT -> AGGGGGGTGTTTTGATCTT
TTGCCTCAGTTAACGAGGT -> TGCCTCAGTTAACGAGGTG
CAGACCTTCTTGAACGCAT -> AGACCTTCTTGAACGCATG
CCGAAAAACCCATCAATTT -> CGAAAAACCCATCAATTTA
CGTCACGGTCTCTGAGGAC -> GTCACGGTCTCTGAGGACC
ATCCCAGCTCATGTGCAAA -> TCCCAGCTCATGTGCAAAT
ACTCCCGTTGTCTTATTGT -> CTCCCGTTGTCTTATTGTA
GGCACCGGACATCTTCTTT -> GCACCGGACATCTTCTTTT
CCCAGAAGAGTACAGGCCT -> CCAGAAGAGTACAGGCCTA
CCGGACATCTTCTTTTTGA -> CGGACATCTTCTTTTTGAG
TGGATCCTTCCTTAGTAAC -> GGATCCTTCCTTAGTAACA
ATAACCATGGCACCGGACA -> TAACCATGGCACCGGACAT
CTCTGGGCACGCTTCGGAT -> TCTGGGCACGCTTCGGATG
TCTGCAACCCCAGAAGAGT -> CTGCAACCCCAGAAGAGTA
TTGACCTCCGATCAGGGTG -> TGACCTCCGATCAGGGTGG
TGTATCGACACAGGATCGA -> GTATCGACACAGGATCGAG
TGTCATATGGGGGAATCCT -> GTCATATGGGGGAATCCTG
ATCGAGCAGCCACATCCTT -> TCGAGCAGCCACATCCTTT
CATCGCCTAGGTATAAAGC -> ATCGCCTAGGTATAAAGCA
ACTATATAAGACGTTCGCA -> CTATATAAGACGTTCGCAA
CGCAGCATACGCCGGGGGG -> GCAGCATACGCCGGGGGGG
GCCAAAATTCACAGTATCA -> CCAAAATTCACAGTATCAA
CCCTTTGAGCGGTTAGTGC -> CCTTTGAGCGGTTAGTGCA
ATTATACGTTTATCGGTAT -> TTATACGTTTATCGGTATT
CGATATCCCTTGCTTTGAT -> GATATCCCTTGCTTTGATC
GTTAACGAGGTGCCTTGGA -> TTAACGAGGTGCCTTGGAT
GGGGTGTCAGCGAACCCGA -> GGGTGTCAGCGAACCCGAA
TTCCCCTCTGGGCACGCTT -> TCCCCTCTGGGCACGCTTC
GATTAGTACTGTCAGCGCT -> ATTAGTACTGTCAGCGCTT
GTTTTCCTGCTGGTAGATG -> TTTTCCTGCTGGTAGATGA
ATATTGTGGGTTGACTACA -> TATTGTGGGTTGACTACAT
CGGCAGGTAGTAGGGCTGA -> GGCAGGTAGTAGGGCTGAA
AACGAAGTGTAAGGCAAGT -> ACGAAGTGTAAGGCAAGTC
AGAATAACCTAATAGGTCT -> GAATAACCTAATAGGTCTC
CCGATCAGGGTGGAGCCTT -> CGATCAGGGTGGAGCCTTA
GAGATCATAATCTGTGTAC -> AGATCATAATCTGTGTACT
GATGGGTACCGGCGTTCGT -> ATGGGTACCGGCGTTCGTT
AGCCACATCCTTTAGCGAA -> GCCACATCCTTTAGCGAAC
TGAGACGATATCCCTTGCT -> GAGACGATATCCCTTGCTT
ATGCGTCACGGTCTCTGAG -> TGCGTCACGGTCTCTGAGG
GCACTGACTATTATACGTT -> CACTGACTATTATACGTTT
ACCGCACTATGCGTTGGCC -> CCGCACTATGCGTTGGCCC
GACAGCAACGACAAGGCGT -> ACAGCAACGACAAGGCGTG
GGATCCTTCCTTAGTAACA -> GATCCTTCCTTAGTAACAA
TTCCACGTATCTGATGAGT -> TCCACGTATCTGATGAGTG
TTCGTTTACACTGTACAAG -> TCGTTTACACTGTACAAGA
GTGGGGTGTCATATGGGGG -> TGGGGTGTCATATGGGGGA
GTATAAAGCATCGGGCTAG -> TATAAAGCATCGGGCTAGA
TTGCCTCTCAGGGGGGTGT -> TGCCTCTCAGGGGGGTGTT
TCAACAGGTCCCATGAGAA -> CAACAGGTCCCATGAGAAC
GGTAACCTTTGTGCAGCCA -> GTAACCTTTGTGCAGCCAC
GTGCTTACGAAGGTTGATA -> TGCTTACGAAGGTTGATAG
AGAACTTGGCGGCAGGTAG -> GAACTTGGCGGCAGGTAGT
CCTTAGTAACAAAGAACTT -> CTTAGTAACAAAGAACTTG,CTTAGTAACAAAGAACTTC,CTTAGTAACAAAGAACTTA,CTTAGTAACAAAGAACTTC
CTACATCCCTGTCGATTAA -> TACATCCCTGTCGATTAAT
GCCCCGCAGGACTACCTTT -> CCCCGCAGGACTACCTTTC
TATCCAAGTCCCGTAAACT -> ATCCAAGTCCCGTAAACTA
TCGCAGATTAGTACTGTCA -> CGCAGATTAGTACTGTCAG
GTTACTACCATCGCCTAGG -> TTACTACCATCGCCTAGGT
GTTCGTTTACACTGTACAA -> TTCGTTTACACTGTACAAG
GCTTTGCGGGTTGTTGCCC -> CTTTGCGGGTTGTTGCCCG
GTAAGGCAAGTCCGCGTCC -> TAAGGCAAGTCCGCGTCCA
TGCATCCCTCACAGAATAA -> GCATCCCTCACAGAATAAC
AATGTTGCGCAGCATACGC -> ATGTTGCGCAGCATACGCC
CCTCTCAGGGGGGTGTTTT -> CTCTCAGGGGGGTGTTTTG
GATTTTGGTCAACAGGTCC -> ATTTTGGTCAACAGGTCCC
TGTCGATTAATAGGTAATC -> GTCGATTAATAGGTAATCG
ACGGAAGTCTAGAACCTGC -> CGGAAGTCTAGAACCTGCC
CAGAATAACCTAATAGGTC -> AGAATAACCTAATAGGTCT
ATCTTCTTTTTGAGTATGC -> TCTTCTTTTTGAGTATGCC
TTAGCGAACAAGTCACGGG -> TAGCGAACAAGTCACGGGA
ATACGCACTGACTATTATA -> TACGCACTGACTATTATAC
TAATAGGTAATCGTATCCG -> AATAGGTAATCGTATCCGG
ATGATGAGCCACCCTTCCG -> TGATGAGCCACCCTTCCGA
AAACTAAACTGACAGCATA -> AACTAAACTGACAGCATAT
ACTTCCACGTATCTGATGA -> CTTCCACGTATCTGATGAG
ATATGGGGGAATCCTGACG -> TATGGGGGAATCCTGACGA
AACCATGGCACCGGACATC -> ACCATGGCACCGGACATCT
CTTCGTTTGTCCAAGCTTT -> TTCGTTTGTCCAAGCTTTT
GGGCACGCTTCGGATGCGT -> GGCACGCTTCGGATGCGTC
CTCGGGGTCAACACAAAGC -> TCGGGGTCAACACAAAGCA
GGGTCAACACAAAGCATTG -> GGTCAACACAAAGCATTGG
CTCACGCCCAAGTACGGTT -> TCACGCCCAAGTACGGTTT
AGTATCGAGATCATAATCT -> GTATCGAGATCATAATCTG
TAGGCGATCCCCAGACCTT -> AGGCGATCCCCAGACCTTC
GAACCCGAAAGATGGCCCT -> AACCCGAAAGATGGCCCTA
GCTTTTTTCCTACCAGTAA -> CTTTTTTCCTACCAGTAAC
GTATGGGTCCGGGTAGGCC -> TATGGGTCCGGGTAGGCCA
ATAATCTGTGTACTCATAT -> TAATCTGTGTACTCATATC
GAATCCTGACGACTGACGT -> AATCCTGACGACTGACGTC
ACTCATATCCAAGTCCCGT -> CTCATATCCAAGTCCCGTA
TTTACCGCACTATGCGTTG -> TTACCGCACTATGCGTTGG
CGATCTGTGTGTGAATGTC -> GATCTGTGTGTGAATGTCA
TCGTTTGTCCAAGCTTTTC -> CGTTTGTCCAAGCTTTTCC
GTACTCCCGTTGTCTTATT -> TACTCCCGTTGTCTTATTG
CACGTATCTGATGAGTGCA -> ACGTATCTGATGAGTGCAT
GTAAATGGATGCTGGACTG -> TAAATGGATGCTGGACTGA
TCATACGGTGCACGAGGTA -> CATACGGTGCACGAGGTAG
CTGCATCCCTCACAGAATA -> TGCATCCCTCACAGAATAA
TTTCACGCTGTGCGGGAAC -> TTCACGCTGTGCGGGAACC
CCAGAAGAGTACAGGCCTA -> CAGAAGAGTACAGGCCTAT
GCGTAGTCTCAGGGTCCGA -> CGTAGTCTCAGGGTCCGAC
CACCGGACATCTTCTTTTT -> ACCGGACATCTTCTTTTTG
TTGGTCTGCAACCCCAGAA -> TGGTCTGCAACCCCAGAAG
TTGTCCCGCAATTTAAACA -> TGTCCCGCAATTTAAACAC
TTCGCAGATTAGTACTGTC -> TCGCAGATTAGTACTGTCA
GGACTAAGGCCCTGCATCC -> GACTAAGGCCCTGCATCCC
CTGGACTGACAGCAACGAC -> TGGACTGACAGCAACGACA
TCCGGGACTAAGGCCCTGC -> CCGGGACTAAGGCCCTGCA
ACGGTTTAAAAGTCAGGTA -> CGGTTTAAAAGTCAGGTAA
GGGTGGAGCCTTAGTAACA -> GGTGGAGCCTTAGTAACAA
GTGTCAGCGAACCCGAAAG -> TGTCAGCGAACCCGAAAGA
TGACGCGTTTTCCTGCTGG -> GACGCGTTTTCCTGCTGGT
GTGTTTTGATCTTGACCTC -> TGTTTTGATCTTGACCTCC
GCCAGAAACGTACTTTTTG -> CCAGAAACGTACTTTTTGT
CCAGCTCCCCGCCAAAATT -> CAGCTCCCCGCCAAAATTC
ATGGGTCCGGGTAGGCCAG -> TGGGTCCGGGTAGGCCAGG
CATCAATTTAGGATTCCCC -> ATCAATTTAGGATTCCCCT
TATCGAGATCATAATCTGT -> ATCGAGATCATAATCTGTG
ATCGACACAGGATCGAGCA -> TCGACACAGGATCGAGCAG
GTAACCTTTGTGCAGCCAC -> TAACCTTTGTGCAGCCACT
TCTATAAATGACAGGGCAT -> CTATAAATGACAGGGCATC
ACAAAGAACTTCGTTTGTC -> CAAAGAACTTCGTTTGTCC
CGGTATGTGCTTACGAAGG -> GGTATGTGCTTACGAAGGT
GGTCCCATGAGAACGTTTG -> GTCCCATGAGAACGTTTGT
CCCTCACAGAATAACCTAA -> CCTCACAGAATAACCTAAT
AGCGAACCCGAAAGATGGC -> GCGAACCCGAAAGATGGCC
CTCATGTGCAAATATTGTG -> TCATGTGCAAATATTGTGG
TTAGTAACAAAGAACTTCC -> TAGTAACAAAGAACTTCCA
CAGGATCGAGCAGCCACAT -> AGGATCGAGCAGCCACATC
AGAACCTGCCCGTTCACCT -> GAACCTGCCCGTTCACCTC
TGGGCGACCCGATCTGTGT -> GGGCGACCCGATCTGTGTG
CGACAAGGCGTGGTGGGGT -> GACAAGGCGTGGTGGGGTG
ACACTTTCAAATTTAGCTG -> CACTTTCAAATTTAGCTGC
TATGTGCTTACGAAGGTTG -> ATGTGCTTACGAAGGTTGA
AAAGAACTTCCACGTATCT -> AAGAACTTCCACGTATCTG
CAGTAACTCTGCAGTGGTA -> AGTAACTCTGCAGTGGTAT
CTTAGTAACAAAGAACTTC -> TTAGTAACAAAGAACTTCC,TTAGTAACAAAGAACTTCG
AATGGAGATGGGCGACCCG -> ATGGAGATGGGCGACCCGA
ATGTGGTATGATGAGCCAC -> TGTGGTATGATGAGCCACC
CGAGTAGATACGGAAACCT -> GAGTAGATACGGAAACCTT
GTTGATAGTTTGATCTTGA -> TTGATAGTTTGATCTTGAC
AAGACCTCTCACGATGACG -> AGACCTCTCACGATGACGC
GATTGAGTAAACCTTAGCG -> ATTGAGTAAACCTTAGCGC
GACCCGTAGATACGCCAGA -> ACCCGTAGATACGCCAGAA
TATGATGAGCCACCCTTCC -> ATGATGAGCCACCCTTCCG
TGTAAGGCAAGTCCGCGTC -> GTAAGGCAAGTCCGCGTCC
CGGGTCTATAAATGACAGG -> GGGTCTATAAATGACAGGG
CCCTAGGGTGCAACGCAAT -> CCTAGGGTGCAACGCAATC
GATCTTGACCTCCGAGGGG -> ATCTTGACCTCCGAGGGGC
AATTGCCCTGAGTGTCGCT -> ATTGCCCTGAGTGTCGCTC
TGCCTCTCAGGGGGGTGTT -> GCCTCTCAGGGGGGTGTTT
TAGTCTCAGGGTCCGACGG -> AGTCTCAGGGTCCGACGGG
CGCCGGACGGCCTGAGATG -> GCCGGACGGCCTGAGATGC
GGGTCCGACGGGTCTATAA -> GGTCCGACGGGTCTATAAA
CGGTTAGTGCATACTGGAG -> GGTTAGTGCATACTGGAGA
GAACAAGTCACGGGACTGG -> AACAAGTCACGGGACTGGT
TGAGTGCATACGCACTGAC -> GAGTGCATACGCACTGACT
TGCAACGCAATCGCCTCCA -> GCAACGCAATCGCCTCCAA
CCTGAGATGCATCCTGGGG -> CTGAGATGCATCCTGGGGT
AGCAGCCACATCCTTTAGC -> GCAGCCACATCCTTTAGCG
GGATGCTTCTTCAGCCCCG -> GATGCTTCTTCAGCCCCGC
TGTTGCGCAGCATACGCCG -> GTTGCGCAGCATACGCCGG
CGGATGCGTCACGGTCTCT -> GGATGCGTCACGGTCTCTG
TGCACGAGGTAGGCGATCC -> GCACGAGGTAGGCGATCCC
GTACAAGACCTCTCACGAT -> TACAAGACCTCTCACGATG
ATCTTGACCTCCGAGGGGC -> TCTTGACCTCCGAGGGGCC
CTATTAGAGTTAGAGAATG -> TATTAGAGTTAGAGAATGT
TGTCAGCGCTTTGCGGGTT -> GTCAGCGCTTTGCGGGTTG
CGACGTGGATCCTTCCTTA -> GACGTGGATCCTTCCTTAG
GTCCAAGCTTTTCCCAGTA -> TCCAAGCTTTTCCCAGTAA
GGGGTTACGCTATGTGCCC -> GGGTTACGCTATGTGCCCT
AGATACGCCAGAAACGTAC -> GATACGCCAGAAACGTACT
GCTTCGGATGCGTCACGGT -> CTTCGGATGCGTCACGGTC
TCAGTTAACGAGGTGCCTT -> CAGTTAACGAGGTGCCTTG
AAGAACTTGGCGGCAGGTA -> AGAACTTGGCGGCAGGTAG
AAGAGTACAGGCCTATTAG -> AGAGTACAGGCCTATTAGA
GCTTTTCCCAGTAACAATT -> CTTTTCCCAGTAACAATTT
CCATGAGAACGTTTGTCCC -> CATGAGAACGTTTGTCCCG
CAACACTTTCAAATTTAGC -> AACACTTTCAAATTTAGCT
ATCTTGACCTCCGAAAGGT -> TCTTGACCTCCGAAAGGTG
CTATCGAGTATGATTGAGT -> TATCGAGTATGATTGAGTA
CTGACTATTATACGTTTAT -> TGACTATTATACGTTTATC
CTCTCACGATGACGCGTTT -> TCTCACGATGACGCGTTTT
CATGGCACCGGACATCTTC -> ATGGCACCGGACATCTTCT
CCTCAGTTACTACCATCGC -> CTCAGTTACTACCATCGCC
GTGCCTTGGATGTTGCCTC -> TGCCTTGGATGTTGCCTCT
AACCTAATAGGTCTCACGC -> ACCTAATAGGTCTCACGCC
TATAAAGCATCGGGCTAGA -> ATAAAGCATCGGGCTAGAA
AAAACCCATCAATTTAGGA -> AAACCCATCAATTTAGGAT
CTGCAGTGGTATATAGCGG -> TGCAGTGGTATATAGCGGT
GCAAATATTGTGGGTTGAC -> CAAATATTGTGGGTTGACT
CATCCGATATTCCTCAATT -> ATCCGATATTCCTCAATTT
TCGGATCATCGCGATGCGC -> CGGATCATCGCGATGCGCG
GGTGTCAGCGAACCCGAAA -> GTGTCAGCGAACCCGAAAG
CTTGAACGCATGTTTGCCT -> TTGAACGCATGTTTGCCTC
AGCTGCGGGATGCTTCTTC -> GCTGCGGGATGCTTCTTCA
TGATCTTGACCTCCGAGGG -> GATCTTGACCTCCGAGGGG
GCAATGGAGATGGGCGACC -> CAATGGAGATGGGCGACCC
TTCTTTTTGAGTATGCCCC -> TCTTTTTGAGTATGCCCCT
TACATCCCGAAATTGAGTG -> ACATCCCGAAATTGAGTGG
TCCGCATGCCACAGTATCG -> CCGCATGCCACAGTATCGA
ATCAGGGTGGAGCCTTAGT -> TCAGGGTGGAGCCTTAGTA
TTCCGAAAAACCCATCAAT -> TCCGAAAAACCCATCAATT
GATGCATCCTGGGGTGAGA -> ATGCATCCTGGGGTGAGAC
AACAAGTCACGGGACTGGT -> ACAAGTCACGGGACTGGTC
TGGAGATGGGGTTACGCTA -> GGAGATGGGGTTACGCTAT
ATCCGATATTCCTCAATTT -> TCCGATATTCCTCAATTTA
GTTTGTCCCGCAATTTAAA -> TTTGTCCCGCAATTTAAAC
CGGCGTAGTCTCAGGGTCC -> GGCGTAGTCTCAGGGTCCG
ACTACCTTTCACGCTGTGC -> CTACCTTTCACGCTGTGCG
GATCATAATCTGTGTACTC -> ATCATAATCTGTGTACTCA
GCATCCTGGGGTGAGACGA -> CATCCTGGGGTGAGACGAT
CGCCTCCAACACTTTCAAA -> GCCTCCAACACTTTCAAAT
GAAAAACCCATCAATTTAG -> AAAAACCCATCAATTTAGG
ACGCGTTTTCCTGCTGGTA -> CGCGTTTTCCTGCTGGTAG
TACCTTTCACGCTGTGCGG -> ACCTTTCACGCTGTGCGGG
GACCCAAAGATCGCTTTTT -> ACCCAAAGATCGCTTTTTT
AACTAAACTGACAGCATAT -> ACTAAACTGACAGCATATT
GCCACTGGAGATGGGGTTA -> CCACTGGAGATGGGGTTAC
TACGGTTTAAAAGTCAGGT -> ACGGTTTAAAAGTCAGGTA
GCCCTAGGGTGCAACGCAA -> CCCTAGGGTGCAACGCAAT
AAGTGTAAGGCAAGTCCGC -> AGTGTAAGGCAAGTCCGCG
AAGGCCCTGCATCCCTCAC -> AGGCCCTGCATCCCTCACA
AGGCGTTTGTCCGCCCGAC -> GGCGTTTGTCCGCCCGACT
CGCCAAAATTCACAGTATC -> GCCAAAATTCACAGTATCA
TATTAGATTCCGAGTAGAT -> ATTAGATTCCGAGTAGATA
ACAAGTCACGGGACTGGTC -> CAAGTCACGGGACTGGTCG
AAGCTTTTCCCAGTAACAA -> AGCTTTTCCCAGTAACAAT
ACGAGGTAGGCGATCCCCA -> CGAGGTAGGCGATCCCCAG
TTGAGTGGCTCTCCTGGAC -> TGAGTGGCTCTCCTGGACC
CAATTTAGGATTCCCCTCT -> AATTTAGGATTCCCCTCTG
TGATCTTGACCTCCGACGT -> GATCTTGACCTCCGACGTG
ATCCTTTAGCGAACAAGTC -> TCCTTTAGCGAACAAGTCA
TTAATTGCCCTGAGTGTCG -> TAATTGCCCTGAGTGTCGC
CCCGCAATTTAAACACTCG -> CCGCAATTTAAACACTCGG
GCTGCGGGATGCTTCTTCA -> CTGCGGGATGCTTCTTCAG
CAAGTCCGCGTCCACTGCA -> AAGTCCGCGTCCACTGCAC
GTCCCATGAGAACGTTTGT -> TCCCATGAGAACGTTTGTC
CGGTTTAAAAGTCAGGTAA -> GGTTTAAAAGTCAGGTAAC
TAGATGGGTACCGGCGTTC -> AGATGGGTACCGGCGTTCG
TCGAGATCATAATCTGTGT -> CGAGATCATAATCTGTGTA
CCTGAGTGTCGCTCCTTTT -> CTGAGTGTCGCTCCTTTTT
TAAATGGATGCTGGACTGA -> AAATGGATGCTGGACTGAC
TTCAAATTTAGCTGCGGGA -> TCAAATTTAGCTGCGGGAT
ATCGAGTATGATTGAGTAA -> TCGAGTATGATTGAGTAAA
GGCGTAGTCTCAGGGTCCG -> GCGTAGTCTCAGGGTCCGA
GCAAGTCCGCGTCCACTGC -> CAAGTCCGCGTCCACTGCA
GGGTGTTTTGATCTTGACC -> GGTGTTTTGATCTTGACCT
CCTTGCAGTAAATGGATGC -> CTTGCAGTAAATGGATGCT
GCAATTTAAACACTCGGGG -> CAATTTAAACACTCGGGGT
GGGTGAGACGATATCCCTT -> GGTGAGACGATATCCCTTG
ACTTGGCGGCAGGTAGTAG -> CTTGGCGGCAGGTAGTAGG
TGATCTTGACCTCCGAAAG -> GATCTTGACCTCCGAAAGG
ATACGGAAACCTTGCAGTA -> TACGGAAACCTTGCAGTAA
CTTCTTTTCGCCGGACGGC -> TTCTTTTCGCCGGACGGCC
TGCCCTGAGTGTCGCTCCT -> GCCCTGAGTGTCGCTCCTT
TACATCCCTGTCGATTAAT -> ACATCCCTGTCGATTAATA
CCGACGGGTCTATAAATGA -> CGACGGGTCTATAAATGAC
AACCTTAGCGCCAGCTCCC -> ACCTTAGCGCCAGCTCCCC
AAGTGCACCCTTTGAGCGG -> AGTGCACCCTTTGAGCGGT
CTGGAGATAACATGTGGTA -> TGGAGATAACATGTGGTAT
TAGCGGTATGGGTCCGGGT -> AGCGGTATGGGTCCGGGTA
GGAATCCCAGCTCATGTGC -> GAATCCCAGCTCATGTGCA
AGGGTGCAACGCAATCGCC -> GGGTGCAACGCAATCGCCT
CTGACGTCCATTTCTTAGC -> TGACGTCCATTTCTTAGCT
GAAAGATGGCCCTAGGGTG -> AAAGATGGCCCTAGGGTGC
CCTTCTTGAACGCATGTTT -> CTTCTTGAACGCATGTTTG
TGAGATGCATCCTGGGGTG -> GAGATGCATCCTGGGGTGA
GGACATCTTCTTTTTGAGT -> GACATCTTCTTTTTGAGTA
AGATAACATGTGGTATGAT -> GATAACATGTGGTATGATG
CCAAGTCCCGTAAACTAAA -> CAAGTCCCGTAAACTAAAC
TCTTGACCTCCGAGGGGCC -> CTTGACCTCCGAGGGGCCC
TCGAGCAGCCACATCCTTT -> CGAGCAGCCACATCCTTTA
CGCAGGACTACCTTTCACG -> GCAGGACTACCTTTCACGC
TAAAGCATCGGGCTAGAAT -> AAAGCATCGGGCTAGAATA
GGCGATCCCCAGACCTTCT -> GCGATCCCCAGACCTTCTT
CCTTGCTTTGATCTTGACC -> CTTGCTTTGATCTTGACCT
CCTCCGACGTGGATCCTTC -> CTCCGACGTGGATCCTTCC
CAAATTATGATTCCCCCTT -> AAATTATGATTCCCCCTTA
AAGAACTTCGTTTGTCCAA -> AGAACTTCGTTTGTCCAAG
CTGACAGCATATTCTGGGC -> TGACAGCATATTCTGGGCG
CCCATATCCTTAGTAACAA -> CCATATCCTTAGTAACAAA
ATCCTGACGACTGACGTCC -> TCCTGACGACTGACGTCCA
GAGATGCATCCTGGGGTGA -> AGATGCATCCTGGGGTGAG
ACCCAAAGATCGCTTTTTT -> CCCAAAGATCGCTTTTTTC
GGTATGGGTCCGGGTAGGC -> GTATGGGTCCGGGTAGGCC
TCACCTCAACGCAACCTAA -> CACCTCAACGCAACCTAAT
GAGGTGCCTTGGATGTTGC -> AGGTGCCTTGGATGTTGCC
CTTCTTTTTGAGTATGCCC -> TTCTTTTTGAGTATGCCCC
TACGGTATGTGCTTACGAA -> ACGGTATGTGCTTACGAAG
AGATGACGCAATGGAGATG -> GATGACGCAATGGAGATGG
GGTTACGCTATGTGCCCTG -> GTTACGCTATGTGCCCTGT
ATTTGATCTTGACCTCCGA -> TTTGATCTTGACCTCCGAA
ACGGGACTGGTCGGATCAT -> CGGGACTGGTCGGATCATC
CGTCCATATGCAATGTTGT -> GTCCATATGCAATGTTGTA
ATGGGGTTACGCTATGTGC -> TGGGGTTACGCTATGTGCC
GGGCTAGAATAAAACATCC -> GGCTAGAATAAAACATCCG
GCGGGTTGTTGCCCGGAAT -> CGGGTTGTTGCCCGGAATC
GTGTCATATGGGGGAATCC -> TGTCATATGGGGGAATCCT
TTTGTTCGCAGATTAGTAC -> TTGTTCGCAGATTAGTACT
TCATAATCTGTGTACTCAT -> CATAATCTGTGTACTCATA
GTAGGCGATCCCCAGACCT -> TAGGCGATCCCCAGACCTT
CAACGCAATCGCCTCCAAC -> AACGCAATCGCCTCCAACA
GGACCCGTAGATACGCCAG -> GACCCGTAGATACGCCAGA
AATGGGAACGGAACGGGAC -> ATGGGAACGGAACGGGACC
TAAGGCCCTGCATCCCTCA -> AAGGCCCTGCATCCCTCAC
ATGGGAACGGAACGGGACC -> TGGGAACGGAACGGGACCC
GTGGTATGATGAGCCACCC -> TGGTATGATGAGCCACCCT
CTTCCGAAAAACCCATCAA -> TTCCGAAAAACCCATCAAT
TTTTGTTCGCAGATTAGTA -> TTTGTTCGCAGATTAGTAC
AAAGAACTTCGTTTGTCCA -> AAGAACTTCGTTTGTCCAA
ACCTCCGAAAGGTGTTCTA -> CCTCCGAAAGGTGTTCTAC
TTAGTACTGTCAGCGCTTT -> TAGTACTGTCAGCGCTTTG
GGTCGGATCATCGCGATGC -> GTCGGATCATCGCGATGCG
TATTAGAGTTAGAGAATGT -> ATTAGAGTTAGAGAATGTT
AAATTCACAGTATCAAGAT -> AATTCACAGTATCAAGATT
TTGCGGGTTGTTGCCCGGA -> TGCGGGTTGTTGCCCGGAA
GTACTGTCAGCGCTTTGCG -> TACTGTCAGCGCTTTGCGG
GATGCGCGTGGTACTCCCG -> ATGCGCGTGGTACTCCCGT
ACAAAGAACTTCCACGTAT -> CAAAGAACTTCCACGTATC
TCCGGGTAGGCCAGGCGGC -> CCGGGTAGGCCAGGCGGCG
CCCGTTGTCTTATTGTATT -> CCGTTGTCTTATTGTATTA
AGTGCATACTGGAGATAAC -> GTGCATACTGGAGATAACA
AATTTACCGCACTATGCGT -> ATTTACCGCACTATGCGTT
TTTTTTCCTACCAGTAACT -> TTTTTCCTACCAGTAACTC
CCCTGTCGATTAATAGGTA -> CCTGTCGATTAATAGGTAA
TCTTGAACGCATGTTTGCC -> CTTGAACGCATGTTTGCCT
CTCATATCCAAGTCCCGTA -> TCATATCCAAGTCCCGTAA
TGACCTCCGAGGGGCCCAT -> GACCTCCGAGGGGCCCATA
ACTGACAGCATATTCTGGG -> CTGACAGCATATTCTGGGC
TGTTTGCGGCTCGTATGTC -> GTTTGCGGCTCGTATGTCA
GTGCAACGCAATCGCCTCC -> TGCAACGCAATCGCCTCCA
TTCTTTTCGCCGGACGGCC -> TCTTTTCGCCGGACGGCCT
TTTTGATCTTGACCTCCGA -> TTTGATCTTGACCTCCGAT
CAAGTACGGTTTAAAAGTC -> AAGTACGGTTTAAAAGTCA
CCTTACGGTATGTGCTTAC -> CTTACGGTATGTGCTTACG
GCAACGACAAGGCGTGGTG -> CAACGACAAGGCGTGGTGG
TGCCCGGAATCCCAGCTCA -> GCCCGGAATCCCAGCTCAT
TGTCAGCGAACCCGAAAGA -> GTCAGCGAACCCGAAAGAT
GCCCCTGTAATGGGAACGG -> CCCCTGTAATGGGAACGGA
TACTTTTTGTTCGCAGATT -> ACTTTTTGTTCGCAGATTA
GGGGAATCCTGACGACTGA -> GGGAATCCTGACGACTGAC
AAAGGTGTTCTACCTTAGT -> AAGGTGTTCTACCTTAGTA
TGTGGGTTGACTACATCCC -> GTGGGTTGACTACATCCCG
AACTCTGCAGTGGTATATA -> ACTCTGCAGTGGTATATAG
CGACGGGTCTATAAATGAC -> GACGGGTCTATAAATGACA
GGTATTCAGTTTAGGATGT -> GTATTCAGTTTAGGATGTT
TTTTGCGTCCGCATGCCAC -> TTTGCGTCCGCATGCCACA
ACTGACTATTATACGTTTA -> CTGACTATTATACGTTTAT
CCCGAAAGATGGCCCTAGG -> CCGAAAGATGGCCCTAGGG
TGCATACTGGAGATAACAT -> GCATACTGGAGATAACATG
GGTAATCGTATCCGGGCAC -> GTAATCGTATCCGGGCACC
GCCTCTCAGGGGGGTGTTT -> CCTCTCAGGGGGGTGTTTT
AGGGTCCGACGGGTCTATA -> GGGTCCGACGGGTCTATAA
CACCCTTTGAGCGGTTAGT -> ACCCTTTGAGCGGTTAGTG
ACCTCCGAGGGGCCCATAT -> CCTCCGAGGGGCCCATATC
TTGTGCAGCCACTGGAGAT -> TGTGCAGCCACTGGAGATG
CCATCGCCTAGGTATAAAG -> CATCGCCTAGGTATAAAGC
CCGGAATCCCAGCTCATGT -> CGGAATCCCAGCTCATGTG
GTTGCGCAGCATACGCCGG -> TTGCGCAGCATACGCCGGG
CAGGCCTATTAGAGTTAGA -> AGGCCTATTAGAGTTAGAG
AGGCAAGTCCGCGTCCACT -> GGCAAGTCCGCGTCCACTG
GTCTCACGCCCAAGTACGG -> TCTCACGCCCAAGTACGGT
GCCTTGGATGTTGCCTCTC -> CCTTGGATGTTGCCTCTCA
ACTATTATACGTTTATCGG -> CTATTATACGTTTATCGGT
ACCGGACATCTTCTTTTTG -> CCGGACATCTTCTTTTTGA
GAAGTCTAGAACCTGCCCG -> AAGTCTAGAACCTGCCCGT
CTCAATTTACCGCACTATG -> TCAATTTACCGCACTATGC
CAGTTTAGGATGTTGGTCT -> AGTTTAGGATGTTGGTCTG
AATTTAGCTGCGGGATGCT -> ATTTAGCTGCGGGATGCTT
AGTAACAATTTGATCTTGA -> GTAACAATTTGATCTTGAC
GTATGTCACTATATAAGAC -> TATGTCACTATATAAGACG
TATACGTTTATCGGTATTC -> ATACGTTTATCGGTATTCA
TATGATTGAGTAAACCTTA -> ATGATTGAGTAAACCTTAG
AAAAACCCATCAATTTAGG -> AAAACCCATCAATTTAGGA
CAGGGCATCTTTGATTTTG -> AGGGCATCTTTGATTTTGC
AATCGCCTCCAACACTTTC -> ATCGCCTCCAACACTTTCA
AAAAGTCAGGTAACCTTTG -> AAAGTCAGGTAACCTTTGT
CTCCTGGACCTCAGTTACT -> TCCTGGACCTCAGTTACTA
GGGTACCGGCGTTCGTTTA -> GGTACCGGCGTTCGTTTAC
GTAGGAGATATCCTCAAGT -> TAGGAGATATCCTCAAGTG
GTTTGTCCAAGCTTTTCCC -> TTTGTCCAAGCTTTTCCCA
AAATTGAGTGGCTCTCCTG -> AATTGAGTGGCTCTCCTGG
ACGCTGTGCGGGAACCTAT -> CGCTGTGCGGGAACCTATG
TTTAGCGAACAAGTCACGG -> TTAGCGAACAAGTCACGGG
CTGTGTACTCATATCCAAG -> TGTGTACTCATATCCAAGT
CCTCAGTTAACGAGGTGCC -> CTCAGTTAACGAGGTGCCT
ACCTTCTTGAACGCATGTT -> CCTTCTTGAACGCATGTTT
TGCAATGTTGTATCGACAC -> GCAATGTTGTATCGACACA
AGGTTGATAGTTTGATCTT -> GGTTGATAGTTTGATCTTG
GGGTGTCATATGGGGGAAT -> GGTGTCATATGGGGGAATC
CACGGTCTCTGAGGACCCG -> ACGGTCTCTGAGGACCCGT
CGTGGTACTCCCGTTGTCT -> GTGGTACTCCCGTTGTCTT
TATGGGGGAATCCTGACGA -> ATGGGGGAATCCTGACGAC
GTCTATAAATGACAGGGCA -> TCTATAAATGACAGGGCAT
CTGTAATGGGAACGGAACG -> TGTAATGGGAACGGAACGG
CAGCGAACCCGAAAGATGG -> AGCGAACCCGAAAGATGGC
CTACCATCGCCTAGGTATA -> TACCATCGCCTAGGTATAA
AACAATTTGATCTTGACCT -> ACAATTTGATCTTGACCTC
GCCTAGGTATAAAGCATCG -> CCTAGGTATAAAGCATCGG
GGATCGAGCAGCCACATCC -> GATCGAGCAGCCACATCCT
TATCCGGGCACCTTCTTTT -> ATCCGGGCACCTTCTTTTC
AATGGCATATGTTTGCGGC -> ATGGCATATGTTTGCGGCT
ACAGGGCATCTTTGATTTT -> CAGGGCATCTTTGATTTTG
TTAGGATTCCCCTCTGGGC -> TAGGATTCCCCTCTGGGCA
CAGTATCGAGATCATAATC -> AGTATCGAGATCATAATCT
CTGTGCGGGAACCTATGAT -> TGTGCGGGAACCTATGATA
CCCAGCTCATGTGCAAATA -> CCAGCTCATGTGCAAATAT
AGACCTTCTTGAACGCATG -> GACCTTCTTGAACGCATGT
CTCTGAGGACCCGTAGATA -> TCTGAGGACCCGTAGATAC
TTCTTGAACGCATGTTTGC -> TCTTGAACGCATGTTTGCC
AATGCTCCGGGACTAAGGC -> ATGCTCCGGGACTAAGGCC
ATTAGTACTGTCAGCGCTT -> TTAGTACTGTCAGCGCTTT
CGCCCGACTACATCCCTGT -> GCCCGACTACATCCCTGTC
TGGCCCTAGGGTGCAACGC -> GGCCCTAGGGTGCAACGCA
TAGATTCCGAGTAGATACG -> AGATTCCGAGTAGATACGG
ACATCCTTTAGCGAACAAG -> CATCCTTTAGCGAACAAGT
CGCACTATGCGTTGGCCCA -> GCACTATGCGTTGGCCCAA
ATCAATTTAGGATTCCCCT -> TCAATTTAGGATTCCCCTC
TAATTGCCCTGAGTGTCGC -> AATTGCCCTGAGTGTCGCT
GGTAGTAGGGCTGAAGTTT -> GTAGTAGGGCTGAAGTTTA
ATCGCCTAGGTATAAAGCA -> TCGCCTAGGTATAAAGCAT
GGGACTGGTCGGATCATCG -> GGACTGGTCGGATCATCGC
CGAGGTAGGCGATCCCCAG -> GAGGTAGGCGATCCCCAGA
GGTGTTCTACCTTAGTAAC -> GTGTTCTACCTTAGTAACA
TTGAGCGGTTAGTGCATAC -> TGAGCGGTTAGTGCATACT
GTAGGGCTGAAGTTTATTA -> TAGGGCTGAAGTTTATTAA
AACATCCGATATTCCTCAA -> ACATCCGATATTCCTCAAT
AGAACTTCGTTTGTCCAAG -> GAACTTCGTTTGTCCAAGC
ACATCTTCTTTTTGAGTAT -> CATCTTCTTTTTGAGTATG
TCCACTGCACCGTCCATAT -> CCACTGCACCGTCCATATG
AGTAGGGCTGAAGTTTATT -> GTAGGGCTGAAGTTTATTA
CGGGTAGGCCAGGCGGCGT -> GGGTAGGCCAGGCGGCGTA
TTCCTACCAGTAACTCTGC -> TCCTACCAGTAACTCTGCA
GCTAGAATAAAACATCCGA -> CTAGAATAAAACATCCGAT
TCTCACGATGACGCGTTTT -> CTCACGATGACGCGTTTTC
CTGCGGGATGCTTCTTCAG -> TGCGGGATGCTTCTTCAGC
TTAGATTCCGAGTAGATAC -> TAGATTCCGAGTAGATACG
TGACCTCCGATCAGGGTGG -> GACCTCCGATCAGGGTGGA
TCATCGCGATGCGCGTGGT -> CATCGCGATGCGCGTGGTA
GACTACATCCCTGTCGATT -> ACTACATCCCTGTCGATTA
TTCAGCCCCGCAGGACTAC -> TCAGCCCCGCAGGACTACC
GGACTGGTCGGATCATCGC -> GACTGGTCGGATCATCGCG
CTCCAACACTTTCAAATTT -> TCCAACACTTTCAAATTTA
AAGTACGGTTTAAAAGTCA -> AGTACGGTTTAAAAGTCAG
CGCTTTTTTCCTACCAGTA -> GCTTTTTTCCTACCAGTAA
AGATCATAATCTGTGTACT -> GATCATAATCTGTGTACTC
AAACCCATCAATTTAGGAT -> AACCCATCAATTTAGGATT
TTAAAAGTCAGGTAACCTT -> TAAAAGTCAGGTAACCTTT
ATTAGATTCCGAGTAGATA -> TTAGATTCCGAGTAGATAC
TATGCAATGTTGTATCGAC -> ATGCAATGTTGTATCGACA
TGTGCGGGAACCTATGATA -> GTGCGGGAACCTATGATAA
GGATGTTGCCTCTCAGGGG -> GATGTTGCCTCTCAGGGGG
GGGCACCTTCTTTTCGCCG -> GGCACCTTCTTTTCGCCGG
ACTGGTCGGATCATCGCGA -> CTGGTCGGATCATCGCGAT
ACGCTTCGGATGCGTCACG -> CGCTTCGGATGCGTCACGG
CATTGGGGTGTCAGCGAAC -> ATTGGGGTGTCAGCGAACC
TTCGCAATAGATGGGTACC -> TCGCAATAGATGGGTACCG
ATCTTGACCTCCGATCAGG -> TCTTGACCTCCGATCAGGG
GAGCGGTTAGTGCATACTG -> AGCGGTTAGTGCATACTGG
TAACCTTTGTGCAGCCACT -> AACCTTTGTGCAGCCACTG
GAAATTGAGTGGCTCTCCT -> AAATTGAGTGGCTCTCCTG
AGTTAACGAGGTGCCTTGG -> GTTAACGAGGTGCCTTGGA
AGAAACGTACTTTTTGTTC -> GAAACGTACTTTTTGTTCG
AAGATTTTGGTCAACAGGT -> AGATTTTGGTCAACAGGTC
CAAATATTGTGGGTTGACT -> AAATATTGTGGGTTGACTA
ACGGTATGTGCTTACGAAG -> CGGTATGTGCTTACGAAGG
TCGCCTCCAACACTTTCAA -> CGCCTCCAACACTTTCAAA
TGCGGCTCGTATGTCACTA -> GCGGCTCGTATGTCACTAT
ACCCGAAAGATGGCCCTAG -> CCCGAAAGATGGCCCTAGG
CGACTGACGTCCATTTCTT -> GACTGACGTCCATTTCTTA
TGCAGCCACTGGAGATGGG -> GCAGCCACTGGAGATGGGG
TCACGGGACTGGTCGGATC -> CACGGGACTGGTCGGATCA
GCCTCAGTTAACGAGGTGC -> CCTCAGTTAACGAGGTGCC
GTAAACCTTAGCGCCAGCT -> TAAACCTTAGCGCCAGCTC
GGGGGGGTAGGAGATATCC -> GGGGGGTAGGAGATATCCT
AATGTTGTATCGACACAGG -> ATGTTGTATCGACACAGGA
AGTACTGTCAGCGCTTTGC -> GTACTGTCAGCGCTTTGCG
GATGAGTGCATACGCACTG -> ATGAGTGCATACGCACTGA
GCATCTTTGATTTTGCGTC -> CATCTTTGATTTTGCGTCC
AGGACTACCTTTCACGCTG -> GGACTACCTTTCACGCTGT
ATCATAATCTGTGTACTCA -> TCATAATCTGTGTACTCAT
GCCCAAGTACGGTTTAAAA -> CCCAAGTACGGTTTAAAAG
CGCTTTGCGGGTTGTTGCC -> GCTTTGCGGGTTGTTGCCC
ACACAGGATCGAGCAGCCA -> CACAGGATCGAGCAGCCAC
AGGATGTTGGTCTGCAACC -> GGATGTTGGTCTGCAACCC
CGTTTTCCTGCTGGTAGAT -> GTTTTCCTGCTGGTAGATG
AGTACAGGCCTATTAGAGT -> GTACAGGCCTATTAGAGTT
CTTGCTTTGATCTTGACCT -> TTGCTTTGATCTTGACCTC
CCCCAGACCTTCTTGAACG -> CCCAGACCTTCTTGAACGC
GACTACATCCCGAAATTGA -> ACTACATCCCGAAATTGAG
TTTGATCTTGACCTCCGAT -> TTGATCTTGACCTCCGATC
GATCTTGACCTCCGACGTG -> ATCTTGACCTCCGACGTGG
CTGAGTGTCGCTCCTTTTT -> TGAGTGTCGCTCCTTTTTG
CATGTGCAAATATTGTGGG -> ATGTGCAAATATTGTGGGT
CGAAAGATGGCCCTAGGGT -> GAAAGATGGCCCTAGGGTG
CCGACTACATCCCTGTCGA -> CGACTACATCCCTGTCGAT
TCAACGCAACCTAATTGAG -> CAACGCAACCTAATTGAGG
CTTTCAAATTTAGCTGCGG -> TTTCAAATTTAGCTGCGGG
ATCCTTAGTAACAAAGAAC -> TCCTTAGTAACAAAGAACT
TGGAGATAACATGTGGTAT -> GGAGATAACATGTGGTATG
CCTACCAGTAACTCTGCAG -> CTACCAGTAACTCTGCAGT
ATGGGGGAATCCTGACGAC -> TGGGGGAATCCTGACGACT
CCAGCTCATGTGCAAATAT -> CAGCTCATGTGCAAATATT
ACAAGGCGTGGTGGGGTGT -> CAAGGCGTGGTGGGGTGTC
TAACCATGGCACCGGACAT -> AACCATGGCACCGGACATC
GTAACAAATTATGATTCCC -> TAACAAATTATGATTCCCC
TGCGGGAACCTATGATAAC -> GCGGGAACCTATGATAACG
TCGCCGGACGGCCTGAGAT -> CGCCGGACGGCCTGAGATG
TCAACACAAAGCATTGGGG -> CAACACAAAGCATTGGGGT
AGTAACAAAGAACTTAAGT -> GTAACAAAGAACTTAAGTG
CGGATCATCGCGATGCGCG -> GGATCATCGCGATGCGCGT
CAAAGATCGCTTTTTTCCT -> AAAGATCGCTTTTTTCCTA
GCCAGCTCCCCGCCAAAAT -> CCAGCTCCCCGCCAAAATT
TTTTGGTCAACAGGTCCCA -> TTTGGTCAACAGGTCCCAT
TAACATGTGGTATGATGAG -> AACATGTGGTATGATGAGC
TACGGTGCACGAGGTAGGC -> ACGGTGCACGAGGTAGGCG
GATCCTTCCTTAGTAACAA -> ATCCTTCCTTAGTAACAAA
CTATATAAGACGTTCGCAA -> TATATAAGACGTTCGCAAT
GTTCTACCTTAGTAACAAA -> TTCTACCTTAGTAACAAAG
CCGAAAGATGGCCCTAGGG -> CGAAAGATGGCCCTAGGGT
TCACGATGACGCGTTTTCC -> CACGATGACGCGTTTTCCT
GTTGTATCGACACAGGATC -> TTGTATCGACACAGGATCG
CCTTTTTGTACGTCCTTTC -> CTTTTTGTACGTCCTTTCT
CTCACAGAATAACCTAATA -> TCACAGAATAACCTAATAG
TAGGATTCCCCTCTGGGCA -> AGGATTCCCCTCTGGGCAC
AGGATTCCCCTCTGGGCAC -> GGATTCCCCTCTGGGCACG
TCCTTCCTTAGTAACAAAG -> CCTTCCTTAGTAACAAAGA
AAGGTTGATAGTTTGATCT -> AGGTTGATAGTTTGATCTT
ATGTTGTATCGACACAGGA -> TGTTGTATCGACACAGGAT
CCTCTCACGATGACGCGTT -> CTCTCACGATGACGCGTTT
ATTCCCCTCTGGGCACGCT -> TTCCCCTCTGGGCACGCTT
GATGCTTCTTCAGCCCCGC -> ATGCTTCTTCAGCCCCGCA
ACTCGGGGTCAACACAAAG -> CTCGGGGTCAACACAAAGC
AGATTCCGAGTAGATACGG -> GATTCCGAGTAGATACGGA
GCAGCCACATCCTTTAGCG -> CAGCCACATCCTTTAGCGA
GGTATATAGCGGTATGGGT -> GTATATAGCGGTATGGGTC
GGCTCTCCTGGACCTCAGT -> GCTCTCCTGGACCTCAGTT
TGCAGTGGTATATAGCGGT -> GCAGTGGTATATAGCGGTA
GTTTAGGATGTTGGTCTGC -> TTTAGGATGTTGGTCTGCA
CTTTCATACGGTGCACGAG -> TTTCATACGGTGCACGAGG
ATTGTGGGTTGACTACATC -> TTGTGGGTTGACTACATCC
GGGGTAGGAGATATCCTCA -> GGGTAGGAGATATCCTCAA
GCTGTGCGGGAACCTATGA -> CTGTGCGGGAACCTATGAT
TGGATGCTGGACTGACAGC -> GGATGCTGGACTGACAGCA
TCTCCTGGACCTCAGTTAC -> CTCCTGGACCTCAGTTACT
GCGGCAGGTAGTAGGGCTG -> CGGCAGGTAGTAGGGCTGA
TCCCAGTAACAATTTGATC -> CCCAGTAACAATTTGATCT
GGGGTGTTTTGATCTTGAC -> GGGTGTTTTGATCTTGACC
AACTTCGTTTGTCCAAGCT -> ACTTCGTTTGTCCAAGCTT
CTTGACCTCCGACGTGGAT -> TTGACCTCCGACGTGGATC
CACTATATAAGACGTTCGC -> ACTATATAAGACGTTCGCA
AAATGGCATATGTTTGCGG -> AATGGCATATGTTTGCGGC
AGCATACGCCGGGGGGGTA -> GCATACGCCGGGGGGGTAG
GCGCTTTGCGGGTTGTTGC -> CGCTTTGCGGGTTGTTGCC
ACAGAATAACCTAATAGGT -> CAGAATAACCTAATAGGTC
ACTAAGGCCCTGCATCCCT -> CTAAGGCCCTGCATCCCTC
TATAAATGACAGGGCATCT -> ATAAATGACAGGGCATCTT
TGCCTTGGATGTTGCCTCT -> GCCTTGGATGTTGCCTCTC
TGCAACCCCAGAAGAGTAC -> GCAACCCCAGAAGAGTACA
ATCCCTGTCGATTAATAGG -> TCCCTGTCGATTAATAGGT
GAATGTCAATAACCATGGC -> AATGTCAATAACCATGGCA
AGGAGATATCCTCAAGTGG -> GGAGATATCCTCAAGTGGT
GAGATGGGCGACCCGATCT -> AGATGGGCGACCCGATCTG
TTATTGTATTAGATTCCGA -> TATTGTATTAGATTCCGAG
GGATTCCCCTCTGGGCACG -> GATTCCCCTCTGGGCACGC
AACGAGGTGCCTTGGATGT -> ACGAGGTGCCTTGGATGTT
TTTGCGTCCGCATGCCACA -> TTGCGTCCGCATGCCACAG
TGAGTGGCTCTCCTGGACC -> GAGTGGCTCTCCTGGACCT
CTTTGTGCAGCCACTGGAG -> TTTGTGCAGCCACTGGAGA
TACCATCGCCTAGGTATAA -> ACCATCGCCTAGGTATAAA
CAAGATTTTGGTCAACAGG -> AAGATTTTGGTCAACAGGT
TGCATCCTGGGGTGAGACG -> GCATCCTGGGGTGAGACGA
ATTGCCCTGAGTGTCGCTC -> TTGCCCTGAGTGTCGCTCC
TGTGAATGTCAATAACCAT -> GTGAATGTCAATAACCATG
ATAAGACGTTCGCAATAGA -> TAAGACGTTCGCAATAGAT
CCCGACTACATCCCTGTCG -> CCGACTACATCCCTGTCGA
CGCAATGGAGATGGGCGAC -> GCAATGGAGATGGGCGACC
AACAAAGAACTTCCACGTA -> ACAAAGAACTTCCACGTAT
GATATCCTCAAGTGGTAAC -> ATATCCTCAAGTGGTAACA
GTAGTCTCAGGGTCCGACG -> TAGTCTCAGGGTCCGACGG
GCAATGTTGTATCGACACA -> CAATGTTGTATCGACACAG
TCATATCCAAGTCCCGTAA -> CATATCCAAGTCCCGTAAA
TCTGTGTACTCATATCCAA -> CTGTGTACTCATATCCAAG
TTTATTAATTGCCCTGAGT -> TTATTAATTGCCCTGAGTG
TGTGTGTGAATGTCAATAA -> GTGTGTGAATGTCAATAAC
CCAGAAACGTACTTTTTGT -> CAGAAACGTACTTTTTGTT
CCTCCAACACTTTCAAATT -> CTCCAACACTTTCAAATTT
TCAGCGCTTTGCGGGTTGT -> CAGCGCTTTGCGGGTTGTT
ACCTCTCACGATGACGCGT -> CCTCTCACGATGACGCGTT
TAAATGACAGGGCATCTTT -> AAATGACAGGGCATCTTTG
TGATTTTGCGTCCGCATGC -> GATTTTGCGTCCGCATGCC
CTGTCGATTAATAGGTAAT -> TGTCGATTAATAGGTAATC
ACCTTAGCGCCAGCTCCCC -> CCTTAGCGCCAGCTCCCCG
ACTCTGCAGTGGTATATAG -> CTCTGCAGTGGTATATAGC
CCGTAAACTAAACTGACAG -> CGTAAACTAAACTGACAGC
ACCAGTAACTCTGCAGTGG -> CCAGTAACTCTGCAGTGGT
TCTTTTCGCCGGACGGCCT -> CTTTTCGCCGGACGGCCTG
GAGATAACATGTGGTATGA -> AGATAACATGTGGTATGAT
ACGGTCTCTGAGGACCCGT -> CGGTCTCTGAGGACCCGTA
GTGCATACGCACTGACTAT -> TGCATACGCACTGACTATT
TCCGATCAGGGTGGAGCCT -> CCGATCAGGGTGGAGCCTT
CATCTTCTTTTTGAGTATG -> ATCTTCTTTTTGAGTATGC
CAAAATTCACAGTATCAAG -> AAAATTCACAGTATCAAGA
CGGAAGTCTAGAACCTGCC -> GGAAGTCTAGAACCTGCCC
GCGTCCACTGCACCGTCCA -> CGTCCACTGCACCGTCCAT
TTTAAAAGTCAGGTAACCT -> TTAAAAGTCAGGTAACCTT
GGATGCTGGACTGACAGCA -> GATGCTGGACTGACAGCAA
ATAGTTTGATCTTGACCTC -> TAGTTTGATCTTGACCTCC
AGCCTTAGTAACAAAGAAC -> GCCTTAGTAACAAAGAACT
CAATTTACCGCACTATGCG -> AATTTACCGCACTATGCGT
TGCTCCGGGACTAAGGCCC -> GCTCCGGGACTAAGGCCCT
GAGTGGCTCTCCTGGACCT -> AGTGGCTCTCCTGGACCTC
TCTACCTTAGTAACAAAGA -> CTACCTTAGTAACAAAGAA
GTTTAAAAGTCAGGTAACC -> TTTAAAAGTCAGGTAACCT
CGAGCAGCCACATCCTTTA -> GAGCAGCCACATCCTTTAG
CGCCCAAGTACGGTTTAAA -> GCCCAAGTACGGTTTAAAA
TATGATTCCCCCTTACGGT -> ATGATTCCCCCTTACGGTA
AATCCTGACGACTGACGTC -> ATCCTGACGACTGACGTCC
TCCAAGCTTTTCCCAGTAA -> CCAAGCTTTTCCCAGTAAC
CCGTCCATATGCAATGTTG -> CGTCCATATGCAATGTTGT
GTTTATCGGTATTCAGTTT -> TTTATCGGTATTCAGTTTA
TGGTACTCCCGTTGTCTTA -> GGTACTCCCGTTGTCTTAT
ACTGGAGATGGGGTTACGC -> CTGGAGATGGGGTTACGCT
GATGCGTCACGGTCTCTGA -> ATGCGTCACGGTCTCTGAG
AACCTTGCAGTAAATGGAT -> ACCTTGCAGTAAATGGATG
CCAAAGATCGCTTTTTTCC -> CAAAGATCGCTTTTTTCCT
GTCCGCATGCCACAGTATC -> TCCGCATGCCACAGTATCG
ATTCCGAGTAGATACGGAA -> TTCCGAGTAGATACGGAAA
GCCTATTAGAGTTAGAGAA -> CCTATTAGAGTTAGAGAAT
GTTCACCTCAACGCAACCT -> TTCACCTCAACGCAACCTA
TCCCTGTCGATTAATAGGT -> CCCTGTCGATTAATAGGTA
GTCGGATCATCGCGATGCG -> TCGGATCATCGCGATGCGC
AAATGACAGGGCATCTTTG -> AATGACAGGGCATCTTTGA
GGCGTGGTGGGGTGTCATA -> GCGTGGTGGGGTGTCATAT
TTTTTGTACGTCCTTTCTA -> TTTTGTACGTCCTTTCTAT
CGGGACTGGTCGGATCATC -> GGGACTGGTCGGATCATCG
GTCCCGTAAACTAAACTGA -> TCCCGTAAACTAAACTGAC
GTTCGCAATAGATGGGTAC -> TTCGCAATAGATGGGTACC
CGACTACATCCCTGTCGAT -> GACTACATCCCTGTCGATT
ACGTTTGTCCCGCAATTTA -> CGTTTGTCCCGCAATTTAA
TTGATCTTGACCTCCGACG -> TGATCTTGACCTCCGACGT
CCCAGACCTTCTTGAACGC -> CCAGACCTTCTTGAACGCA
GTGCAGCCACTGGAGATGG -> TGCAGCCACTGGAGATGGG
AAACATCCGATATTCCTCA -> AACATCCGATATTCCTCAA
AACGCAATCGCCTCCAACA -> ACGCAATCGCCTCCAACAC
TTGTTCGCAGATTAGTACT -> TGTTCGCAGATTAGTACTG
CTTCAGCCCCGCAGGACTA -> TTCAGCCCCGCAGGACTAC
TGGTGGGGTGTCATATGGG -> GGTGGGGTGTCATATGGGG
GTAGATACGGAAACCTTGC -> TAGATACGGAAACCTTGCA
TACAAGACCTCTCACGATG -> ACAAGACCTCTCACGATGA
CGCTATGTGCCCTGTGAGG -> GCTATGTGCCCTGTGAGGC
TCGTATGTCACTATATAAG -> CGTATGTCACTATATAAGA
CCGGGTAGGCCAGGCGGCG -> CGGGTAGGCCAGGCGGCGT
TGAGAACGTTTGTCCCGCA -> GAGAACGTTTGTCCCGCAA
CTAGAATAAAACATCCGAT -> TAGAATAAAACATCCGATA
ATGATTGAGTAAACCTTAG -> TGATTGAGTAAACCTTAGC
TTACCGCACTATGCGTTGG -> TACCGCACTATGCGTTGGC
TGCAAATATTGTGGGTTGA -> GCAAATATTGTGGGTTGAC
GCATACTGGAGATAACATG -> CATACTGGAGATAACATGT
TAGGGCTGAAGTTTATTAA -> AGGGCTGAAGTTTATTAAT
TGACCTCCGAAAGGTGTTC -> GACCTCCGAAAGGTGTTCT
TGCGCAGCATACGCCGGGG -> GCGCAGCATACGCCGGGGG
CTTAAGTGCACCCTTTGAG -> TTAAGTGCACCCTTTGAGC
ATTGAGGAATGCTCCGGGA -> TTGAGGAATGCTCCGGGAC
CAGTAACAATTTGATCTTG -> AGTAACAATTTGATCTTGA
ACTGTACAAGACCTCTCAC -> CTGTACAAGACCTCTCACG
GGGTTGACTACATCCCGAA -> GGTTGACTACATCCCGAAA
AGCATCGGGCTAGAATAAA -> GCATCGGGCTAGAATAAAA
AATAAAACATCCGATATTC -> ATAAAACATCCGATATTCC
TAACAATTTGATCTTGACC -> AACAATTTGATCTTGACCT
CCCAAATGGCATATGTTTG -> CCAAATGGCATATGTTTGC
GATATCCCTTGCTTTGATC -> ATATCCCTTGCTTTGATCT
AAGTCCCGTAAACTAAACT -> AGTCCCGTAAACTAAACTG
TAGAACCTGCCCGTTCACC -> AGAACCTGCCCGTTCACCT
TAGATGACGCAATGGAGAT -> AGATGACGCAATGGAGATG
TTAGCTTTCATACGGTGCA -> TAGCTTTCATACGGTGCAC
GATCGCTTTTTTCCTACCA -> ATCGCTTTTTTCCTACCAG
ACGACAAGGCGTGGTGGGG -> CGACAAGGCGTGGTGGGGT
GTCCACTGCACCGTCCATA -> TCCACTGCACCGTCCATAT
TAGAATAAAACATCCGATA -> AGAATAAAACATCCGATAT
CGATATTCCTCAATTTACC -> GATATTCCTCAATTTACCG
GAAGAGTACAGGCCTATTA -> AAGAGTACAGGCCTATTAG
TCCCGTTGTCTTATTGTAT -> CCCGTTGTCTTATTGTATT
GCATGCCACAGTATCGAGA -> CATGCCACAGTATCGAGAT
CCTAGGTATAAAGCATCGG -> CTAGGTATAAAGCATCGGG
CCAGTAACAATTTGATCTT -> CAGTAACAATTTGATCTTG
AGGTAGTAGGGCTGAAGTT -> GGTAGTAGGGCTGAAGTTT
GTTTTGATCTTGACCTCCG -> TTTTGATCTTGACCTCCGA
AGGTAGGCGATCCCCAGAC -> GGTAGGCGATCCCCAGACC
GATCATCGCGATGCGCGTG -> ATCATCGCGATGCGCGTGG
CTCTCCTGGACCTCAGTTA -> TCTCCTGGACCTCAGTTAC
TTGTCCGCCCGACTACATC -> TGTCCGCCCGACTACATCC
CTTCCACGTATCTGATGAG -> TTCCACGTATCTGATGAGT
CGCAATCGCCTCCAACACT -> GCAATCGCCTCCAACACTT
TGCACCGTCCATATGCAAT -> GCACCGTCCATATGCAATG
GTGTTCTACCTTAGTAACA -> TGTTCTACCTTAGTAACAA
CGCATGTTTGCCTCAGTTA -> GCATGTTTGCCTCAGTTAA
CATCCCTCACAGAATAACC -> ATCCCTCACAGAATAACCT
TACTACCATCGCCTAGGTA -> ACTACCATCGCCTAGGTAT
GCGTTCGTTTACACTGTAC -> CGTTCGTTTACACTGTACA
GTCCTTTCTATCGAGTATG -> TCCTTTCTATCGAGTATGA
CGTAGATACGCCAGAAACG -> GTAGATACGCCAGAAACGT
AGTCACGGGACTGGTCGGA -> GTCACGGGACTGGTCGGAT
ATACGGTGCACGAGGTAGG -> TACGGTGCACGAGGTAGGC
AGTGCATACGCACTGACTA -> GTGCATACGCACTGACTAT
ATCCAAGTCCCGTAAACTA -> TCCAAGTCCCGTAAACTAA
ATCGCTTTTTTCCTACCAG -> TCGCTTTTTTCCTACCAGT
AACGTTTGTCCCGCAATTT -> ACGTTTGTCCCGCAATTTA
TATCCTTAGTAACAAAGAA -> ATCCTTAGTAACAAAGAAC
TGGCTCTCCTGGACCTCAG -> GGCTCTCCTGGACCTCAGT
TTAGGATGTTGGTCTGCAA -> TAGGATGTTGGTCTGCAAC
TGTTTTGATCTTGACCTCC -> GTTTTGATCTTGACCTCCG
CGAAAGGTGTTCTACCTTA -> GAAAGGTGTTCTACCTTAG
TTTGCCTCAGTTAACGAGG -> TTGCCTCAGTTAACGAGGT
CTGCACCGTCCATATGCAA -> TGCACCGTCCATATGCAAT
TAGAGTTAGAGAATGTTGC -> AGAGTTAGAGAATGTTGCG
CCTATTAGAGTTAGAGAAT -> CTATTAGAGTTAGAGAATG
TGCATACGCACTGACTATT -> GCATACGCACTGACTATTA
GGTGCAACGCAATCGCCTC -> GTGCAACGCAATCGCCTCC
CCGCGTCCACTGCACCGTC -> CGCGTCCACTGCACCGTCC
CCCCCTTACGGTATGTGCT -> CCCCTTACGGTATGTGCTT
TGCGTCACGGTCTCTGAGG -> GCGTCACGGTCTCTGAGGA
CGTATCTGATGAGTGCATA -> GTATCTGATGAGTGCATAC
CCTTTCACGCTGTGCGGGA -> CTTTCACGCTGTGCGGGAA
ACTATGCGTTGGCCCAAAT -> CTATGCGTTGGCCCAAATG
ATTTAGGATTCCCCTCTGG -> TTTAGGATTCCCCTCTGGG
CGTCCATTTCTTAGCTTTC -> GTCCATTTCTTAGCTTTCA
GCGTCCGCATGCCACAGTA -> CGTCCGCATGCCACAGTAT
AACAAAGAACTTAAGTGCA -> ACAAAGAACTTAAGTGCAC
CAATGGAGATGGGCGACCC -> AATGGAGATGGGCGACCCG
CGTTTATCGGTATTCAGTT -> GTTTATCGGTATTCAGTTT
TAGCGAACAAGTCACGGGA -> AGCGAACAAGTCACGGGAC
TCAGTTTAGGATGTTGGTC -> CAGTTTAGGATGTTGGTCT
TAATAGGTCTCACGCCCAA -> AATAGGTCTCACGCCCAAG
TTTGAGTATGCCCCTGTAA -> TTGAGTATGCCCCTGTAAT
AACAAAGAACTTGGCGGCA -> ACAAAGAACTTGGCGGCAG
CAATAGATGGGTACCGGCG -> AATAGATGGGTACCGGCGT
ATCCCTCACAGAATAACCT -> TCCCTCACAGAATAACCTA
GGCTAGAATAAAACATCCG -> GCTAGAATAAAACATCCGA
TGGGGTGTCATATGGGGGA -> GGGGTGTCATATGGGGGAA
GCGCCAGCTCCCCGCCAAA -> CGCCAGCTCCCCGCCAAAA
TGGCCCAAATGGCATATGT -> GGCCCAAATGGCATATGTT
CACTGCACCGTCCATATGC -> ACTGCACCGTCCATATGCA
CTCCGAAAGGTGTTCTACC -> TCCGAAAGGTGTTCTACCT
TACGAAGGTTGATAGTTTG -> ACGAAGGTTGATAGTTTGA
TCCAAGTCCCGTAAACTAA -> CCAAGTCCCGTAAACTAAA
ACAGCAACGACAAGGCGTG -> CAGCAACGACAAGGCGTGG
AGAGTACAGGCCTATTAGA -> GAGTACAGGCCTATTAGAG
TGCCCGTTCACCTCAACGC -> GCCCGTTCACCTCAACGCA
AATTATGATTCCCCCTTAC -> ATTATGATTCCCCCTTACG
AAGCATTGGGGTGTCAGCG -> AGCATTGGGGTGTCAGCGA
TGTGCCCTGTGAGGCGTTT -> GTGCCCTGTGAGGCGTTTG
CTTGACCTCCGAGGGGCCC -> TTGACCTCCGAGGGGCCCA
ACTTCGTTTGTCCAAGCTT -> CTTCGTTTGTCCAAGCTTT
TGGCGGCAGGTAGTAGGGC -> GGCGGCAGGTAGTAGGGCT
ACCTAATAGGTCTCACGCC -> CCTAATAGGTCTCACGCCC
TCCTTAGTAACAAAGAACT -> CCTTAGTAACAAAGAACTT,CCTTAGTAACAAAGAACTT
ATCGTATCCGGGCACCTTC -> TCGTATCCGGGCACCTTCT
CCTGTCGATTAATAGGTAA -> CTGTCGATTAATAGGTAAT
GTTTGCCTCAGTTAACGAG -> TTTGCCTCAGTTAACGAGG
ATGCTTCTTCAGCCCCGCA -> TGCTTCTTCAGCCCCGCAG
GTCGCTCCTTTTTGTACGT -> TCGCTCCTTTTTGTACGTC
TAACCTAATAGGTCTCACG -> AACCTAATAGGTCTCACGC
AGTATGATTGAGTAAACCT -> GTATGATTGAGTAAACCTT
TGATAGTTTGATCTTGACC -> GATAGTTTGATCTTGACCT
CAGCATACGCCGGGGGGGT -> AGCATACGCCGGGGGGGTA
TTACGAAGGTTGATAGTTT -> TACGAAGGTTGATAGTTTG
GTTAGTGCATACTGGAGAT -> TTAGTGCATACTGGAGATA
CTGCTGGTAGATGACGCAA -> TGCTGGTAGATGACGCAAT
AACACAAAGCATTGGGGTG -> ACACAAAGCATTGGGGTGT
GGTGCACGAGGTAGGCGAT -> GTGCACGAGGTAGGCGATC
TCGATTAATAGGTAATCGT -> CGATTAATAGGTAATCGTA
GCCGGGGGGGTAGGAGATA -> CCGGGGGGGTAGGAGATAT
TGTCACTATATAAGACGTT -> GTCACTATATAAGACGTTC
TAGGCCAGGCGGCGTAGTC -> AGGCCAGGCGGCGTAGTCT
GGGGTCAACACAAAGCATT -> GGGTCAACACAAAGCATTG
GATACGGAAACCTTGCAGT -> ATACGGAAACCTTGCAGTA
CGCGTCCACTGCACCGTCC -> GCGTCCACTGCACCGTCCA
TTTGCGGGTTGTTGCCCGG -> TTGCGGGTTGTTGCCCGGA
GACACAGGATCGAGCAGCC -> ACACAGGATCGAGCAGCCA
CCAGGCGGCGTAGTCTCAG -> CAGGCGGCGTAGTCTCAGG
CGAGGTGCCTTGGATGTTG -> GAGGTGCCTTGGATGTTGC
GTTGTTGCCCGGAATCCCA -> TTGTTGCCCGGAATCCCAG
CATCCCTGTCGATTAATAG -> ATCCCTGTCGATTAATAGG
GAGTGTCGCTCCTTTTTGT -> AGTGTCGCTCCTTTTTGTA
CCAGTAACTCTGCAGTGGT -> CAGTAACTCTGCAGTGGTA
CGCGTTTTCCTGCTGGTAG -> GCGTTTTCCTGCTGGTAGA
GTGTAAGGCAAGTCCGCGT -> TGTAAGGCAAGTCCGCGTC
AGATGGGTACCGGCGTTCG -> GATGGGTACCGGCGTTCGT
CTCAAGTGGTAACAAATTA -> TCAAGTGGTAACAAATTAT
AAGAACTTCCACGTATCTG -> AGAACTTCCACGTATCTGA
GGTAGGAGATATCCTCAAG -> GTAGGAGATATCCTCAAGT
AGCGAACAAGTCACGGGAC -> GCGAACAAGTCACGGGACT
TAACAAAGAACTTCGTTTG -> AACAAAGAACTTCGTTTGT
TTGATAGTTTGATCTTGAC -> TGATAGTTTGATCTTGACC
TGTGCAAATATTGTGGGTT -> GTGCAAATATTGTGGGTTG
GTTTATTAATTGCCCTGAG -> TTTATTAATTGCCCTGAGT
GGCCTATTAGAGTTAGAGA -> GCCTATTAGAGTTAGAGAA
ACGCCCAAGTACGGTTTAA -> CGCCCAAGTACGGTTTAAA
TTGGTCAACAGGTCCCATG -> TGGTCAACAGGTCCCATGA
ATCCTGGGGTGAGACGATA -> TCCTGGGGTGAGACGATAT
TACCGCACTATGCGTTGGC -> ACCGCACTATGCGTTGGCC
ACTTTCAAATTTAGCTGCG -> CTTTCAAATTTAGCTGCGG
TATGGGTCCGGGTAGGCCA -> ATGGGTCCGGGTAGGCCAG
GTGTGAATGTCAATAACCA -> TGTGAATGTCAATAACCAT
GCAACGCAATCGCCTCCAA -> CAACGCAATCGCCTCCAAC
TTTCATACGGTGCACGAGG -> TTCATACGGTGCACGAGGT
AGACGGAAGTCTAGAACCT -> GACGGAAGTCTAGAACCTG
ACTGGAGATAACATGTGGT -> CTGGAGATAACATGTGGTA
GGTCAACACAAAGCATTGG -> GTCAACACAAAGCATTGGG
GACGTTCGCAATAGATGGG -> ACGTTCGCAATAGATGGGT
TTGTCTTATTGTATTAGAT -> TGTCTTATTGTATTAGATT
TATGTTTGCGGCTCGTATG -> ATGTTTGCGGCTCGTATGT
CTTCTTCAGCCCCGCAGGA -> TTCTTCAGCCCCGCAGGAC
TGTTGTATCGACACAGGAT -> GTTGTATCGACACAGGATC
GGTAGGCCAGGCGGCGTAG -> GTAGGCCAGGCGGCGTAGT
AGATTTTGGTCAACAGGTC -> GATTTTGGTCAACAGGTCC
ACAGGTCCCATGAGAACGT -> CAGGTCCCATGAGAACGTT
ACATCCCTGTCGATTAATA -> CATCCCTGTCGATTAATAG
CACGGGACTGGTCGGATCA -> ACGGGACTGGTCGGATCAT
TGTAATGGGAACGGAACGG -> GTAATGGGAACGGAACGGG
GATAACATGTGGTATGATG -> ATAACATGTGGTATGATGA
GACGACTGACGTCCATTTC -> ACGACTGACGTCCATTTCT
TGCTGGTAGATGACGCAAT -> GCTGGTAGATGACGCAATG
GTGCACGAGGTAGGCGATC -> TGCACGAGGTAGGCGATCC
ACAAAGAACTTAAGTGCAC -> CAAAGAACTTAAGTGCACC
TTGAGGAATGCTCCGGGAC -> TGAGGAATGCTCCGGGACT
AGCTCCCCGCCAAAATTCA -> GCTCCCCGCCAAAATTCAC
CCCGTAGATACGCCAGAAA -> CCGTAGATACGCCAGAAAC
CGGGACTAAGGCCCTGCAT -> GGGACTAAGGCCCTGCATC
CGCTCCTTTTTGTACGTCC -> GCTCCTTTTTGTACGTCCT
AGTGTAAGGCAAGTCCGCG -> GTGTAAGGCAAGTCCGCGT
ACAAGACCTCTCACGATGA -> CAAGACCTCTCACGATGAC
ACGATATCCCTTGCTTTGA -> CGATATCCCTTGCTTTGAT
CTCCGACGTGGATCCTTCC -> TCCGACGTGGATCCTTCCT
TGAGCCACCCTTCCGAAAA -> GAGCCACCCTTCCGAAAAA
TTGGCGGCAGGTAGTAGGG -> TGGCGGCAGGTAGTAGGGC
AGTATCAAGATTTTGGTCA -> GTATCAAGATTTTGGTCAA
TGTGTGAATGTCAATAACC -> GTGTGAATGTCAATAACCA
GGCATCTTTGATTTTGCGT -> GCATCTTTGATTTTGCGTC
TACGTTTATCGGTATTCAG -> ACGTTTATCGGTATTCAGT
ACTAAACTGACAGCATATT -> CTAAACTGACAGCATATTC
ACGGCCTGAGATGCATCCT -> CGGCCTGAGATGCATCCTG
GTCTTATTGTATTAGATTC -> TCTTATTGTATTAGATTCC
TGACTACATCCCGAAATTG -> GACTACATCCCGAAATTGA
CGGTGCACGAGGTAGGCGA -> GGTGCACGAGGTAGGCGAT
AGCTTTCATACGGTGCACG -> GCTTTCATACGGTGCACGA
GCTTTCATACGGTGCACGA -> CTTTCATACGGTGCACGAG
CGGGCTAGAATAAAACATC -> GGGCTAGAATAAAACATCC
GTCATATGGGGGAATCCTG -> TCATATGGGGGAATCCTGA
CGGCGTTCGTTTACACTGT -> GGCGTTCGTTTACACTGTA
ATGGCATATGTTTGCGGCT -> TGGCATATGTTTGCGGCTC
TAAACACTCGGGGTCAACA -> AAACACTCGGGGTCAACAC
AATATTGTGGGTTGACTAC -> ATATTGTGGGTTGACTACA
CCGTTGTCTTATTGTATTA -> CGTTGTCTTATTGTATTAG
CCGCATGCCACAGTATCGA -> CGCATGCCACAGTATCGAG
GAGAATGTTGCGCAGCATA -> AGAATGTTGCGCAGCATAC
ACGCCAGAAACGTACTTTT -> CGCCAGAAACGTACTTTTT
TGGGGTTACGCTATGTGCC -> GGGGTTACGCTATGTGCCC
GACTGGTCGGATCATCGCG -> ACTGGTCGGATCATCGCGA
GAGGGGCCCATATCCTTAG -> AGGGGCCCATATCCTTAGT
TCCCCTCTGGGCACGCTTC -> CCCCTCTGGGCACGCTTCG
AAACCTTGCAGTAAATGGA -> AACCTTGCAGTAAATGGAT
CGTCCTTTCTATCGAGTAT -> GTCCTTTCTATCGAGTATG
ATGTTTGCGGCTCGTATGT -> TGTTTGCGGCTCGTATGTC
ACGCAATCGCCTCCAACAC -> CGCAATCGCCTCCAACACT
AGATGGGGTTACGCTATGT -> GATGGGGTTACGCTATGTG
ACGTTTATCGGTATTCAGT -> CGTTTATCGGTATTCAGTT
CTTGACCTCCGAAAGGTGT -> TTGACCTCCGAAAGGTGTT
TGACGCAATGGAGATGGGC -> GACGCAATGGAGATGGGCG
CTTATTGTATTAGATTCCG -> TTATTGTATTAGATTCCGA
ACCTCCGACGTGGATCCTT -> CCTCCGACGTGGATCCTTC
AGCCCCGCAGGACTACCTT -> GCCCCGCAGGACTACCTTT
TAACAAAGAACTTCCACGT -> AACAAAGAACTTCCACGTA
GAGGCGTTTGTCCGCCCGA -> AGGCGTTTGTCCGCCCGAC
GGAGATGGGGTTACGCTAT -> GAGATGGGGTTACGCTATG
TATGTGCCCTGTGAGGCGT -> ATGTGCCCTGTGAGGCGTT
AGACGTTCGCAATAGATGG -> GACGTTCGCAATAGATGGG
AAAGTCAGGTAACCTTTGT -> AAGTCAGGTAACCTTTGTG
AAAATTCACAGTATCAAGA -> AAATTCACAGTATCAAGAT
GCATCCCTCACAGAATAAC -> CATCCCTCACAGAATAACC
TAGTAACAAAGAACTTAAG -> AGTAACAAAGAACTTAAGT
CTGGACCTCAGTTACTACC -> TGGACCTCAGTTACTACCA
GTTGCCCGGAATCCCAGCT -> TTGCCCGGAATCCCAGCTC
GAAGTGTAAGGCAAGTCCG -> AAGTGTAAGGCAAGTCCGC
GGTTAGTGCATACTGGAGA -> GTTAGTGCATACTGGAGAT
TGCCTCAGTTAACGAGGTG -> GCCTCAGTTAACGAGGTGC
TACCGGCGTTCGTTTACAC -> ACCGGCGTTCGTTTACACT
ATGGCCCTAGGGTGCAACG -> TGGCCCTAGGGTGCAACGC
TGTTGGTCTGCAACCCCAG -> GTTGGTCTGCAACCCCAGA
TTTGTCCAAGCTTTTCCCA -> TTGTCCAAGCTTTTCCCAG
ACCTATGATAACGAAGTGT -> CCTATGATAACGAAGTGTA
GACGGCCTGAGATGCATCC -> ACGGCCTGAGATGCATCCT
GATCTGTGTGTGAATGTCA -> ATCTGTGTGTGAATGTCAA
GTGGTGGGGTGTCATATGG -> TGGTGGGGTGTCATATGGG
GACATCTTCTTTTTGAGTA -> ACATCTTCTTTTTGAGTAT
ATATAGCGGTATGGGTCCG -> TATAGCGGTATGGGTCCGG
CGGGCACCTTCTTTTCGCC -> GGGCACCTTCTTTTCGCCG
GAAACGTACTTTTTGTTCG -> AAACGTACTTTTTGTTCGC
GCTGGACTGACAGCAACGA -> CTGGACTGACAGCAACGAC
CTACCAGTAACTCTGCAGT -> TACCAGTAACTCTGCAGTG
GCTTACGAAGGTTGATAGT -> CTTACGAAGGTTGATAGTT
GATCAGGGTGGAGCCTTAG -> ATCAGGGTGGAGCCTTAGT
CCTGCCCGTTCACCTCAAC -> CTGCCCGTTCACCTCAACG
ATGGGCGACCCGATCTGTG -> TGGGCGACCCGATCTGTGT
AAGACGGAAGTCTAGAACC -> AGACGGAAGTCTAGAACCT
CACAAAGCATTGGGGTGTC -> ACAAAGCATTGGGGTGTCA
ACTGACGTCCATTTCTTAG -> CTGACGTCCATTTCTTAGC
GACTGACAGCAACGACAAG -> ACTGACAGCAACGACAAGG
TGAACGCATGTTTGCCTCA -> GAACGCATGTTTGCCTCAG
CAGCTCCCCGCCAAAATTC -> AGCTCCCCGCCAAAATTCA
TGTCGCTCCTTTTTGTACG -> GTCGCTCCTTTTTGTACGT
ATGGCACCGGACATCTTCT -> TGGCACCGGACATCTTCTT
GCGGGATGCTTCTTCAGCC -> CGGGATGCTTCTTCAGCCC
TGTTGCCCGGAATCCCAGC -> GTTGCCCGGAATCCCAGCT
GAGTTAGAGAATGTTGCGC -> AGTTAGAGAATGTTGCGCA
CCCAGTAACAATTTGATCT -> CCAGTAACAATTTGATCTT
CATATGTTTGCGGCTCGTA -> ATATGTTTGCGGCTCGTAT
CACCTTCTTTTCGCCGGAC -> ACCTTCTTTTCGCCGGACG
ACCTTTCACGCTGTGCGGG -> CCTTTCACGCTGTGCGGGA
GGTCTCTGAGGACCCGTAG -> GTCTCTGAGGACCCGTAGA
AATAGATGGGTACCGGCGT -> ATAGATGGGTACCGGCGTT
TGTGTACTCATATCCAAGT -> GTGTACTCATATCCAAGTC
TTGATCTTGACCTCCGATC -> TGATCTTGACCTCCGATCA
TGCTTTGATCTTGACCTCC -> GCTTTGATCTTGACCTCCG
CACAGTATCAAGATTTTGG -> ACAGTATCAAGATTTTGGT
GACGATATCCCTTGCTTTG -> ACGATATCCCTTGCTTTGA
GAGTACAGGCCTATTAGAG -> AGTACAGGCCTATTAGAGT
TCACGCTGTGCGGGAACCT -> CACGCTGTGCGGGAACCTA
CCATATGCAATGTTGTATC -> CATATGCAATGTTGTATCG
AACCTAATTGAGGAATGCT -> ACCTAATTGAGGAATGCTC
TTGTGGGTTGACTACATCC -> TGTGGGTTGACTACATCCC
GCACCTTCTTTTCGCCGGA -> CACCTTCTTTTCGCCGGAC
TCGCGATGCGCGTGGTACT -> CGCGATGCGCGTGGTACTC
CGAAGTGTAAGGCAAGTCC -> GAAGTGTAAGGCAAGTCCG
ATGACGCGTTTTCCTGCTG -> TGACGCGTTTTCCTGCTGG
GATTCCCCCTTACGGTATG -> ATTCCCCCTTACGGTATGT
CCCGAAATTGAGTGGCTCT -> CCGAAATTGAGTGGCTCTC
GTGCAAATATTGTGGGTTG -> TGCAAATATTGTGGGTTGA
TCTTATTGTATTAGATTCC -> CTTATTGTATTAGATTCCG
GCCCAAATGGCATATGTTT -> CCCAAATGGCATATGTTTG
CAAGCTTTTCCCAGTAACA -> AAGCTTTTCCCAGTAACAA
ATAACCTAATAGGTCTCAC -> TAACCTAATAGGTCTCACG
AGGTAACCTTTGTGCAGCC -> GGTAACCTTTGTGCAGCCA
GAACCTGCCCGTTCACCTC -> AACCTGCCCGTTCACCTCA
TGTCCGCCCGACTACATCC -> GTCCGCCCGACTACATCCC
AGTGCACCCTTTGAGCGGT -> GTGCACCCTTTGAGCGGTT
TTCTACCTTAGTAACAAAG -> TCTACCTTAGTAACAAAGA
GTCCGGGTAGGCCAGGCGG -> TCCGGGTAGGCCAGGCGGC
CCGGGCACCTTCTTTTCGC -> CGGGCACCTTCTTTTCGCC
TTGGGGTGTCAGCGAACCC -> TGGGGTGTCAGCGAACCCG
CTGAGATGCATCCTGGGGT -> TGAGATGCATCCTGGGGTG
GGTACTCCCGTTGTCTTAT -> GTACTCCCGTTGTCTTATT
GAACGGAACGGGACCCAAA -> AACGGAACGGGACCCAAAG
TCCCGTAAACTAAACTGAC -> CCCGTAAACTAAACTGACA
ACTGCACCGTCCATATGCA -> CTGCACCGTCCATATGCAA
AGGGCTGAAGTTTATTAAT -> GGGCTGAAGTTTATTAATT
TGCGGGATGCTTCTTCAGC -> GCGGGATGCTTCTTCAGCC
TACTCATATCCAAGTCCCG -> ACTCATATCCAAGTCCCGT
TTTTCCTGCTGGTAGATGA -> TTTCCTGCTGGTAGATGAC
GATGTTGGTCTGCAACCCC -> ATGTTGGTCTGCAACCCCA
TCTGCAGTGGTATATAGCG -> CTGCAGTGGTATATAGCGG
CCTTGGATGTTGCCTCTCA -> CTTGGATGTTGCCTCTCAG
GTCAACACAAAGCATTGGG -> TCAACACAAAGCATTGGGG
CACAGGATCGAGCAGCCAC -> ACAGGATCGAGCAGCCACA
AAGTCAGGTAACCTTTGTG -> AGTCAGGTAACCTTTGTGC
GATGACGCAATGGAGATGG -> ATGACGCAATGGAGATGGG
GAACTTAAGTGCACCCTTT -> AACTTAAGTGCACCCTTTG
TGAGGCGTTTGTCCGCCCG -> GAGGCGTTTGTCCGCCCGA
TTAGTAACAAAGAACTTGG -> TAGTAACAAAGAACTTGGC
TAACAAAGAACTTGGCGGC -> AACAAAGAACTTGGCGGCA
TCCCTTGCTTTGATCTTGA -> CCCTTGCTTTGATCTTGAC
TAGGGTGCAACGCAATCGC -> AGGGTGCAACGCAATCGCC
GCTCCGGGACTAAGGCCCT -> CTCCGGGACTAAGGCCCTG
CACCGTCCATATGCAATGT -> ACCGTCCATATGCAATGTT
AGGACCCGTAGATACGCCA -> GGACCCGTAGATACGCCAG
AGGTCCCATGAGAACGTTT -> GGTCCCATGAGAACGTTTG
TCCTTTAGCGAACAAGTCA -> CCTTTAGCGAACAAGTCAC
TTGGATGTTGCCTCTCAGG -> TGGATGTTGCCTCTCAGGG
GCGCGTGGTACTCCCGTTG -> CGCGTGGTACTCCCGTTGT
GAGAACGTTTGTCCCGCAA -> AGAACGTTTGTCCCGCAAT
TTTAAACACTCGGGGTCAA -> TTAAACACTCGGGGTCAAC
GGTAGATGACGCAATGGAG -> GTAGATGACGCAATGGAGA
TTCACCTCAACGCAACCTA -> TCACCTCAACGCAACCTAA
CGTTTGTCCGCCCGACTAC -> GTTTGTCCGCCCGACTACA
TATGTCACTATATAAGACG -> ATGTCACTATATAAGACGT
AACTTAAGTGCACCCTTTG -> ACTTAAGTGCACCCTTTGA
CCGTTCACCTCAACGCAAC -> CGTTCACCTCAACGCAACC
TCAGCGAACCCGAAAGATG -> CAGCGAACCCGAAAGATGG
TGTACGTCCTTTCTATCGA -> GTACGTCCTTTCTATCGAG
AATCCCAGCTCATGTGCAA -> ATCCCAGCTCATGTGCAAA
TTGCGGCTCGTATGTCACT -> TGCGGCTCGTATGTCACTA
TACTGTCAGCGCTTTGCGG -> ACTGTCAGCGCTTTGCGGG
AGTTACTACCATCGCCTAG -> GTTACTACCATCGCCTAGG
AACAAAGAACTTCGTTTGT -> ACAAAGAACTTCGTTTGTC
TAGGAGATATCCTCAAGTG -> AGGAGATATCCTCAAGTGG
CCTGTGAGGCGTTTGTCCG -> CTGTGAGGCGTTTGTCCGC
AGACGATATCCCTTGCTTT -> GACGATATCCCTTGCTTTG
ATGTTGCCTCTCAGGGGGG -> TGTTGCCTCTCAGGGGGGT
TGCACCCTTTGAGCGGTTA -> GCACCCTTTGAGCGGTTAG
TGGGGTGTCAGCGAACCCG -> GGGGTGTCAGCGAACCCGA
AACGGAACGGGACCCAAAG -> ACGGAACGGGACCCAAAGA
CAAAGAACTTCCACGTATC -> AAAGAACTTCCACGTATCT
CTTGGATGTTGCCTCTCAG -> TTGGATGTTGCCTCTCAGG
ACCGTCCATATGCAATGTT -> CCGTCCATATGCAATGTTG
CCAACACTTTCAAATTTAG -> CAACACTTTCAAATTTAGC
CGATCCCCAGACCTTCTTG -> GATCCCCAGACCTTCTTGA
AGCCACTGGAGATGGGGTT -> GCCACTGGAGATGGGGTTA
AAAGAACTTGGCGGCAGGT -> AAGAACTTGGCGGCAGGTA
GTAGATACGCCAGAAACGT -> TAGATACGCCAGAAACGTA
TGGTATATAGCGGTATGGG -> GGTATATAGCGGTATGGGT
ATTCCTCAATTTACCGCAC -> TTCCTCAATTTACCGCACT
TGAATGTCAATAACCATGG -> GAATGTCAATAACCATGGC
TCGGGCTAGAATAAAACAT -> CGGGCTAGAATAAAACATC
CACATCCTTTAGCGAACAA -> ACATCCTTTAGCGAACAAG
TTTACACTGTACAAGACCT -> TTACACTGTACAAGACCTC
ACCTCCGATCAGGGTGGAG -> CCTCCGATCAGGGTGGAGC
TGAGCGGTTAGTGCATACT -> GAGCGGTTAGTGCATACTG
TTAGTAACAAAGAACTTCG -> TAGTAACAAAGAACTTCGT
TTTGTCCGCCCGACTACAT -> TTGTCCGCCCGACTACATC
TCTGGGCACGCTTCGGATG -> CTGGGCACGCTTCGGATGC
ATCGCGATGCGCGTGGTAC -> TCGCGATGCGCGTGGTACT
AGAATAAAACATCCGATAT -> GAATAAAACATCCGATATT
GCGACCCGATCTGTGTGTG -> CGACCCGATCTGTGTGTGA
CTTGACCTCCGATCAGGGT -> TTGACCTCCGATCAGGGTG
TGATGAGTGCATACGCACT -> GATGAGTGCATACGCACTG
CCCGTTCACCTCAACGCAA -> CCGTTCACCTCAACGCAAC
CCAAATGGCATATGTTTGC -> CAAATGGCATATGTTTGCG
TTTCCTGCTGGTAGATGAC -> TTCCTGCTGGTAGATGACG
GGTACCGGCGTTCGTTTAC -> GTACCGGCGTTCGTTTACA
AGGCCAGGCGGCGTAGTCT -> GGCCAGGCGGCGTAGTCTC
CTCCGAGGGGCCCATATCC -> TCCGAGGGGCCCATATCCT
CCTTCCGAAAAACCCATCA -> CTTCCGAAAAACCCATCAA
GCAGGACTACCTTTCACGC -> CAGGACTACCTTTCACGCT
AGAACGTTTGTCCCGCAAT -> GAACGTTTGTCCCGCAATT
AACGACAAGGCGTGGTGGG -> ACGACAAGGCGTGGTGGGG
GTGGTAACAAATTATGATT -> TGGTAACAAATTATGATTC
CGGTCTCTGAGGACCCGTA -> GGTCTCTGAGGACCCGTAG
GCCGGACGGCCTGAGATGC -> CCGGACGGCCTGAGATGCA
CCCTGTGAGGCGTTTGTCC -> CCTGTGAGGCGTTTGTCCG
ATCTGTGTGTGAATGTCAA -> TCTGTGTGTGAATGTCAAT
CCTGTAATGGGAACGGAAC -> CTGTAATGGGAACGGAACG
AAGTCTAGAACCTGCCCGT -> AGTCTAGAACCTGCCCGTT
TTTGATCTTGACCTCCGAG -> TTGATCTTGACCTCCGAGG
CTATGTGCCCTGTGAGGCG -> TATGTGCCCTGTGAGGCGT
GCACCGGACATCTTCTTTT -> CACCGGACATCTTCTTTTT
AGTTTGATCTTGACCTCCG -> GTTTGATCTTGACCTCCGA
GAGTATGCCCCTGTAATGG -> AGTATGCCCCTGTAATGGG
TTGTACGTCCTTTCTATCG -> TGTACGTCCTTTCTATCGA
TGGTCTGCAACCCCAGAAG -> GGTCTGCAACCCCAGAAGA
ATGATAACGAAGTGTAAGG -> TGATAACGAAGTGTAAGGC
GCCCGGAATCCCAGCTCAT -> CCCGGAATCCCAGCTCATG
CCGCAATTTAAACACTCGG -> CGCAATTTAAACACTCGGG
GGTTGACTACATCCCGAAA -> GTTGACTACATCCCGAAAT
ACCCCAGAAGAGTACAGGC -> CCCCAGAAGAGTACAGGCC
GGTCCGGGTAGGCCAGGCG -> GTCCGGGTAGGCCAGGCGG
GGGGTGTCATATGGGGGAA -> GGGTGTCATATGGGGGAAT
CCCCGCCAAAATTCACAGT -> CCCGCCAAAATTCACAGTA
CGGAATCCCAGCTCATGTG -> GGAATCCCAGCTCATGTGC
TTTCTTAGCTTTCATACGG -> TTCTTAGCTTTCATACGGT
CTTCCTTAGTAACAAAGAA -> TTCCTTAGTAACAAAGAAC
CATAATCTGTGTACTCATA -> ATAATCTGTGTACTCATAT
GGTGGAGCCTTAGTAACAA -> GTGGAGCCTTAGTAACAAA
ATGCAATGTTGTATCGACA -> TGCAATGTTGTATCGACAC
GAGATGGGGTTACGCTATG -> AGATGGGGTTACGCTATGT
CGTTTGTCCCGCAATTTAA -> GTTTGTCCCGCAATTTAAA
AAGATCGCTTTTTTCCTAC -> AGATCGCTTTTTTCCTACC
CTTACGGTATGTGCTTACG -> TTACGGTATGTGCTTACGA
CCTCCGATCAGGGTGGAGC -> CTCCGATCAGGGTGGAGCC
CGAACCCGAAAGATGGCCC -> GAACCCGAAAGATGGCCCT
CCCCTGTAATGGGAACGGA -> CCCTGTAATGGGAACGGAA
GCAACCTAATTGAGGAATG -> CAACCTAATTGAGGAATGC
TTTAGGATTCCCCTCTGGG -> TTAGGATTCCCCTCTGGGC
TCAATTTAGGATTCCCCTC -> CAATTTAGGATTCCCCTCT
GAACTTCGTTTGTCCAAGC -> AACTTCGTTTGTCCAAGCT
GCTCATGTGCAAATATTGT -> CTCATGTGCAAATATTGTG
CCCTGCATCCCTCACAGAA -> CCTGCATCCCTCACAGAAT
TGCGGGTTGTTGCCCGGAA -> GCGGGTTGTTGCCCGGAAT
ACAGTATCAAGATTTTGGT -> CAGTATCAAGATTTTGGTC
AGTTAGAGAATGTTGCGCA -> GTTAGAGAATGTTGCGCAG
AACGTACTTTTTGTTCGCA -> ACGTACTTTTTGTTCGCAG
CTATGCGTTGGCCCAAATG -> TATGCGTTGGCCCAAATGG
GCCCGACTACATCCCTGTC -> CCCGACTACATCCCTGTCG
TATCCCTTGCTTTGATCTT -> ATCCCTTGCTTTGATCTTG
TACGGAAACCTTGCAGTAA -> ACGGAAACCTTGCAGTAAA
ACCCTTTGAGCGGTTAGTG -> CCCTTTGAGCGGTTAGTGC
ATATGCAATGTTGTATCGA -> TATGCAATGTTGTATCGAC
TAGTAACAAAGAACTTCCA -> AGTAACAAAGAACTTCCAC
TTCCTTAGTAACAAAGAAC -> TCCTTAGTAACAAAGAACT
TTTGTACGTCCTTTCTATC -> TTGTACGTCCTTTCTATCG
TGCGTTGGCCCAAATGGCA -> GCGTTGGCCCAAATGGCAT
TCGGTATTCAGTTTAGGAT -> CGGTATTCAGTTTAGGATG
AACCTATGATAACGAAGTG -> ACCTATGATAACGAAGTGT
CACTATGCGTTGGCCCAAA -> ACTATGCGTTGGCCCAAAT
ACATCCCGAAATTGAGTGG -> CATCCCGAAATTGAGTGGC
CCCAAAGATCGCTTTTTTC -> CCAAAGATCGCTTTTTTCC
GATGGGCGACCCGATCTGT -> ATGGGCGACCCGATCTGTG
ACACTCGGGGTCAACACAA -> CACTCGGGGTCAACACAAA
ATGAGAACGTTTGTCCCGC -> TGAGAACGTTTGTCCCGCA
TCTTGACCTCCGAAAGGTG -> CTTGACCTCCGAAAGGTGT
CCTTTGTGCAGCCACTGGA -> CTTTGTGCAGCCACTGGAG
TTCCGAGTAGATACGGAAA -> TCCGAGTAGATACGGAAAC
GATTAATAGGTAATCGTAT -> ATTAATAGGTAATCGTATC
GGAACCTATGATAACGAAG -> GAACCTATGATAACGAAGT
AATTTAAACACTCGGGGTC -> ATTTAAACACTCGGGGTCA
ACGTATCTGATGAGTGCAT -> CGTATCTGATGAGTGCATA
GATGTTGCCTCTCAGGGGG -> ATGTTGCCTCTCAGGGGGG
CAGGACTACCTTTCACGCT -> AGGACTACCTTTCACGCTG
CTTAGCTTTCATACGGTGC -> TTAGCTTTCATACGGTGCA
GTATGATTGAGTAAACCTT -> TATGATTGAGTAAACCTTA
TTCTTCAGCCCCGCAGGAC -> TCTTCAGCCCCGCAGGACT
GGGGGGTGTTTTGATCTTG -> GGGGGTGTTTTGATCTTGA
CACGCCCAAGTACGGTTTA -> ACGCCCAAGTACGGTTTAA
TTATGATTCCCCCTTACGG -> TATGATTCCCCCTTACGGT
TTTTTCCTACCAGTAACTC -> TTTTCCTACCAGTAACTCT
TAATCGTATCCGGGCACCT -> AATCGTATCCGGGCACCTT
GGCCCTGCATCCCTCACAG -> GCCCTGCATCCCTCACAGA
TACGTCCTTTCTATCGAGT -> ACGTCCTTTCTATCGAGTA
ATGAGCCACCCTTCCGAAA -> TGAGCCACCCTTCCGAAAA
GAATAACCTAATAGGTCTC -> AATAACCTAATAGGTCTCA
TTTCCTACCAGTAACTCTG -> TTCCTACCAGTAACTCTGC
TGTCCCGCAATTTAAACAC -> GTCCCGCAATTTAAACACT
TGGTATGATGAGCCACCCT -> GGTATGATGAGCCACCCTT
ACGTACTTTTTGTTCGCAG -> CGTACTTTTTGTTCGCAGA
TTTCAAATTTAGCTGCGGG -> TTCAAATTTAGCTGCGGGA
GCGGGAACCTATGATAACG -> CGGGAACCTATGATAACGA
CTCCCCGCCAAAATTCACA -> TCCCCGCCAAAATTCACAG
TTGAGTATGCCCCTGTAAT -> TGAGTATGCCCCTGTAATG
ATGCTCCGGGACTAAGGCC -> TGCTCCGGGACTAAGGCCC
AGAAGAGTACAGGCCTATT -> GAAGAGTACAGGCCTATTA
ACTTAAGTGCACCCTTTGA -> CTTAAGTGCACCCTTTGAG
CAATAACCATGGCACCGGA -> AATAACCATGGCACCGGAC
AATGACAGGGCATCTTTGA -> ATGACAGGGCATCTTTGAT
TATGCGTTGGCCCAAATGG -> ATGCGTTGGCCCAAATGGC
TCGACACAGGATCGAGCAG -> CGACACAGGATCGAGCAGC
GAGGAATGCTCCGGGACTA -> AGGAATGCTCCGGGACTAA
GTCAGCGAACCCGAAAGAT -> TCAGCGAACCCGAAAGATG
TCACGCCCAAGTACGGTTT -> CACGCCCAAGTACGGTTTA
TCGTATCCGGGCACCTTCT -> CGTATCCGGGCACCTTCTT
GGCCCAAATGGCATATGTT -> GCCCAAATGGCATATGTTT
ATATCCTCAAGTGGTAACA -> TATCCTCAAGTGGTAACAA
AAAGCATCGGGCTAGAATA -> AAGCATCGGGCTAGAATAA
GACCTCAGTTACTACCATC -> ACCTCAGTTACTACCATCG
ATGTGCTTACGAAGGTTGA -> TGTGCTTACGAAGGTTGAT
GTCACGGTCTCTGAGGACC -> TCACGGTCTCTGAGGACCC
CCCTCTGGGCACGCTTCGG -> CCTCTGGGCACGCTTCGGA
GTCCCGCAATTTAAACACT -> TCCCGCAATTTAAACACTC
GCTTCTTCAGCCCCGCAGG -> CTTCTTCAGCCCCGCAGGA
TCCCCCTTACGGTATGTGC -> CCCCCTTACGGTATGTGCT
GTCTAGAACCTGCCCGTTC -> TCTAGAACCTGCCCGTTCA
GGCAAGTCCGCGTCCACTG -> GCAAGTCCGCGTCCACTGC
TAGGATGTTGGTCTGCAAC -> AGGATGTTGGTCTGCAACC
AACACTCGGGGTCAACACA -> ACACTCGGGGTCAACACAA
ATTTCTTAGCTTTCATACG -> TTTCTTAGCTTTCATACGG
GACCTCCGAGGGGCCCATA -> ACCTCCGAGGGGCCCATAT
GGGACTAAGGCCCTGCATC -> GGACTAAGGCCCTGCATCC
TTTAGCTGCGGGATGCTTC -> TTAGCTGCGGGATGCTTCT
CCACTGCACCGTCCATATG -> CACTGCACCGTCCATATGC
CCCTTGCTTTGATCTTGAC -> CCTTGCTTTGATCTTGACC
AATAACCTAATAGGTCTCA -> ATAACCTAATAGGTCTCAC
CTTCGGATGCGTCACGGTC -> TTCGGATGCGTCACGGTCT
GTGTCGCTCCTTTTTGTAC -> TGTCGCTCCTTTTTGTACG
TAGCTTTCATACGGTGCAC -> AGCTTTCATACGGTGCACG
CCGCCCGACTACATCCCTG -> CGCCCGACTACATCCCTGT
ATGCCCCTGTAATGGGAAC -> TGCCCCTGTAATGGGAACG
CAACCTAATTGAGGAATGC -> AACCTAATTGAGGAATGCT
ATCTGTGTACTCATATCCA -> TCTGTGTACTCATATCCAA
TGATCTTGACCTCCGATCA -> GATCTTGACCTCCGATCAG
TGACAGCAACGACAAGGCG -> GACAGCAACGACAAGGCGT
TAGTAACAAAGAACTTGGC -> AGTAACAAAGAACTTGGCG
